property_id,cash_buyer,sold_to,bought_for,sold_for,net
R171398,PORTLAND LEEDS LIVING LLC,NORTHWEST NEIGHBORS FOR,1000000,2250000,1250000
R327191,"BRENNEKE,THOMAS B &",4700 SW HUMPHREY LLC,3250000,4278250,1028250
R327284,TREECE & LAMBERT LLC,"DUA,BHUPESH &",250000,1130000,880000
R188043,MOUNT STORM PROPERTIES LLC,"NEWMAN,LUCAS M &",370000,1070000,700000
R198184,"LONGBROOK,JUDY L TR","EHLEN,NICHOLAS R TR",603000,1300000,697000
R188748,"ELLIS,JAMES &","JACOBS,PETER A &",477000,1149000,672000
R172967,REAL VALUE HOMES LLC,"MACDONALD,LAUREL W",375000,990000,615000
R260752,KCD INVESTMENTS LLC,"SEITZINGER,KELLY &",350000,949000,599000
R260632,BUNDY HARRINGTON HOMES LLC,"CHASTENEY,EDWARD A IV &",353000,935000,582000
R230261,"SARASON,MARGARET W &","MODHA,ASHOK &",722500,1300000,577500
R301054,REAL VALUE HOMES LLC,"COOKSEY,ELIZABETH L &",400000,955000,555000
R301054,REAL VALUE HOMES LLC,"COOKSY,ELIZABETH L &",400000,955000,555000
R170248,DILLUSO HOMES LLC,"HARDER,DUSTIN G &",432000,956500,524500
R259888,DHR RENOVATION INC,"HUGHES,CHAD J &",306000,830000,524000
R224346,"HANSON,LELAND E","HENDERSON,SARAH",925000,1445000,520000
R101487,"YORK,JOHN &","AMOS,TELLISA &",416000,935000,519000
R147344,KCD INVESTMENTS LLC,"HANSON,KRISTI J",360000,870000,510000
R288428,DILUSSO HOMES LLC,"KEPLINGER,GUY L &",346000,853200,507200
R203198,DILUSSO HOMES LLC,"SAHNI,VIKRAM &",390000,895000,505000
R203298,DILUSSO HOMES LLC,"RICHARD,ROBERT B TR &",405000,895000,490000
R171444,CASA BONITA DE M&P; LLC,"DEHART,MARNI R &",575000,1065000,490000
R257977,PORTLAND DEVELOPMENT GROUP LLC,"LAMOUREUX,STEPHEN T &",460000,950000,490000
R113071,CREO PROPERTIES LLC,"HABER,STEPHEN B &",310000,795940,485940
R101279,"WEIGANDT,BRADLEY &","PEITHMAN,ROBERT C TR &",375000,859900,484900
R203268,DILUSSO HOMES LLC &,"LAING,BRYAN &",350000,832000,482000
R203300,DILUSSO HOMES LLC,"BUNKER,GILLIAN L &",400000,879900,479900
R309579,LA JOLLA MJ MANAGEMENT II LLC,"HEIN,TROY &",371000,850000,479000
R199599,"REILLY,JOHN K &","MAKLER,JONATHAN T &",375000,849000,474000
R254985,RENAISSANCE CUSTOM HOMES LLC,"CLAUSEN,CARYLL E D TR",265000,736000,471000
R327626,"HIBBEN,BRANDY","VIRDEN,IRA &",450000,920000,470000
R112619,LAJOLLA MJ MANAGEMENT II LLC,"GUPTA,RISHI R &",380000,849000,469000
R309387,HERMES BROS LLC,"MINTER,MICHAEL R &",362500,830000,467500
R183441,DILUSSO HOMES LLC,"VOS,DOUGLAS K &",290000,754000,464000
R112739,"OLSON,OLIVER","HILDRUM,THOMAS E &",475000,939000,464000
R166958,"SILVER,BENJAMIN G","ADAMS,RUKAIYAH",255300,718000,462700
R146563,CITY REDEVELOPMENT 2 LLC,"BACHRACH,JEFF",159000,620000,461000
R273606,RENAISSANCE CUSTOM HOMES LLC,"TIMROTT,SHANNYN Z R &",240000,699900,459900
R260817,"REILLY,JOHN K &","DEPPER,LINDA S &",320000,779000,459000
R202733,DILUSSO HOMES LLC,"BRAHMAVAR,AMEET S &",340000,790000,450000
R295800,DILUSSO HOMES LLC,"TREAT,CHARLES E &",246000,695000,449000
R147783,"REILLY,JOHN K &","MILLER,STEPHEN V &",500000,944000,444000
R230764,PORTLAND DEVELOPMENT GROUP,"CARCIERI,ELIZABETH &",285000,726000,441000
R262428,"REILLY,JOHN K &","WRAY,WENDY",300000,740000,440000
R262412,HOUSE TO HOME RENOVATION LLC,"LIEBERMAN,AMY E &",330000,769900,439900
R247406,BGP VENTURES,"REID,VICKI &",325000,762000,437000
R259374,"DOHERTY-REILLY,JENNIFER","TATE,KEVIN &",345000,781000,436000
R203995,"REILLY,JOHN K &","KRAMER,PETER C &",330000,765000,435000
R112877,"REILLY,JOHN &","BYRD,KEVIN J &",330000,765000,435000
R260756,DILUSSO HOMES LLC,"PATTERSON,DAVID R &",349000,780575,431575
R187269,"FRANCE,KEVIN &","MCDONALD,JASON &",325000,755500,430500
R187559,JT & LS HOLDINGS LLC,"KENAGY,JOHN J",410000,839629,429629
R267148,NSI INVESTMENTS LLC,"HODGSON,CLINTON J &",239000,667000,428000
R262183,CLASSIC IMAGE HOMES LLC,"SARFF,MARYCLARE S",232000,659900,427900
R260747,"REILLY,JOHN K &","THEDE,MARK A &",291685,715000,423315
R187879,MOUNT STORM PROPERTIES LLC,"GROSS,MICHELLE M &",460000,881360,421360
R255304,"DANIELS,BLAKE","GRISSOM,DAN",370000,790000,420000
R262392,"REILLY,JOHN K &","AUZINS,NORMUND K",350000,770000,420000
R309433,PORTLAND DEVELOPMENT GROUP,"SCOTTOLINE,BRIAN &",382500,800000,417500
R203301,"REILLY,JOHN K &","SHIELDS,KIMBERLY A &",340000,756000,416000
R188972,"GILL,CHARLES","PERKINS,JASON D &",300000,715000,415000
R309482,"REILLY,JOHN K &","KIRKISH,JONATHAN J &",315000,729000,414000
R142756,MORRISON BUILT LLC,"BATES,JONATHAN &",225000,638000,413000
R200251,PORTLAND DEVELOPMENT GROUP LLC,"BECKSTROM,LANCE A &",375000,787300,412300
R182818,DILUSSO HOMES LLC,"THOMAS,MATTHEW &",350000,760000,410000
R652994,PORTLAND REDEVELOPMENT LLC,"COPPOLA,KRISTIN-50% &",180000,590000,410000
R147743,"REILLY,JOHN &","SAMS,PETER B &",425000,830000,405000
R250045,BIG MOOSE DEVELOPMENT INC,"SPRAGUE,FRED &",216000,620000,404000
R147207,DILUSSO HOMES LLC,"BIFANO,JENNIFER L &",281000,684900,403900
R165389,"DOBRANSKI,MICHAEL L &","VINCENT,FREDERICK &",672000,1075000,403000
R147405,WILDE PROPERTIES INC,"SHANER,GINA &",291000,692000,401000
R148349,WESTWOOD HOMES LLC,"DEWEY,BRENNAN H &",184750,585342,400592
R184155,WEST COAST DEVELOPMENT,"GRIGSBY,SCOTT R &",200000,599900,399900
R182751,"REILLY,JOHN K &","WALKER,JASON R &",262500,659000,396500
R193139,PEAR POINT INVESTMENTS LLC,"BONIFACE,CHRISTOPHER T &",525000,920000,395000
R299808,LA JOLLA MJ MANAGEMENT II,"DIWAN,MURTAZA A &",430000,825000,395000
R129306,"KLOSS,SHIRLEY TR","LUTZE,CARA J &",175000,570000,395000
R240901,NSI INVESTMENTS LLC,"PARDEE,THOMAS C &",158000,552500,394500
R260136,ROYAL CUSTOM HOMES INC,"LEE,SUNG J &",266000,660000,394000
R172759,RENAISSANCE CUSTOM HOMES LLC,"CHRUSOSKIE,AARON A &",180000,573724,393724
R123868,RENAISSANCE CUSTOM HOMES LLC,"MCGEE,MATTHEW E &",160000,549900,389900
R113136,DILUSSO HOMES LLC,"MURRAY,GARRETT L",370000,759000,389000
R295846,"CARPENTER,MICHAEL C &","COLE,NOAH J &",230000,618319,388319
R115035,DILUSSO HOMES LLC,"NELSON,HOLLY &",243333,631000,387667
R306299,"KEPPINGER,KATHLEEN","HEUSER,ROSE G &",318000,704000,386000
R147138,"GERLACH,JONATHAN L","STARR,MATTHEW A &",315000,701000,386000
R231485,DILUSSO HOMES LLC,"SCHEIHING,JEFF D &",291000,677000,386000
R294527,PERFORMANCE HOMES LLC,"TRIPLETT,HEATHER L &",210000,595000,385000
R134638,GERRITZ ENTERPRISES INC,"SPERAZZA,MICHAEL &",315000,700000,385000
R134460,MORRISON BUILT LLC &,"FIRTH,SCOTT &",265000,650000,385000
R182739,"REILLY,JOHN K &","LE PORE,CHRISTOPHER P &",250000,635000,385000
R282884,NSI INVESTMENTS LLC,"BERANEK,RANDY",249000,633750,384750
R175380,DILUSSO HOMES LLC,"XIAO,HONG",307400,691000,383600
R285223,"KALUF,SAMIR","KASS,ROBERT C TR-50% &",565000,948250,383250
R214518,CKW CONSTRUCTION LLC,"OH,JOHN",317500,699000,381500
R303739,NSI INVESTMENTS LLC,"MOGGRIDGE,KARIN H TR",300000,680000,380000
R291617,4925 SW 18TH PLACE LLC,"MEJICANO,GEORGE &",270000,650000,380000
R285291,RUBY NORTHWEST LLC,"BROOKS,DAVID F &",250000,629000,379000
R187658,"DICHTER,ALAN &","THOMPSON,MICHELE M &",507000,885000,378000
R128465,"SILVER,BENJAMIN G","WALI,BASHAR K &",582250,960000,377750
R231568,DILUSSO HOMES LLC,"COLWELL,MEGAN G &",262000,637500,375500
R188086,"REILLY,JOHN K &","PAUL,ANDREW J &",375000,750000,375000
R155569,DILUSSO HOMES LLC,"ABBOTT,KRISTEN L",220000,595000,375000
R137076,NSI INVESTMENTS LLC,"YOKOYAMA,JENNA &",140000,512500,372500
R230281,LA JOLLA MJ MANAGEMENT II LLC,"BAILEY,STEVEN T &",527000,899000,372000
R262621,DILUSSO HOMES LLC,"GUARRAIA,DAVID &",379000,750000,371000
R204309,"REILLY,JOHN K &","TORREY,SCOT TR &",330000,700000,370000
R203635,"LEIPHON,DENNIS D","KEENER,KARL A &",420000,789900,369900
R191406,RENAISSANCE CUSTOM HOMES LLC,"FROST,ALEXANDER S",182000,549900,367900
R102772,4918 NE 9TH LLC,"DOTSON,ANTHONY B &",150000,515000,365000
R203418,"MCCHESNEY,ELIZABETH R","LYNOTT,C K &",375000,740000,365000
R234236,GASLIGHT PROPERTIES LLC,"SOTTILE,MATTHEW &",249000,612000,363000
R186588,PORTLAND REDEVELOPMENT LLC,"ALEXANDER,STEFFAN &",255000,617000,362000
R163633,DEZ DEVELOPMENT LLC,"MCELROY,RANDALL W &",140000,501468,361468
R188637,JT & LS HOLDINGS LLC,"THORNTON,CORY R",385000,745644,360644
R215407,RENAISSANCE CUSTOM HOMES LLC,"DICKENS,RODNEY E &",210000,568851,358851
R113920,"AYLWIN,RUFUS","BOYD,BRADEN T &",142000,499500,357500
R112720,"LEIPHON,DENNIS D","AUERBACH,STEPHEN &",353000,710000,357000
R262372,FOUR SQUARE DESIGN/BUILD LLC,FUNDADOR INC,305000,660000,355000
R259280,"BRANDS,JULIE &","BROWN,ANDREW &",343000,694900,351900
R267860,RENAISSANCE CUSTOM HOMES LLC,"BYERS,JONATHAN D",245000,596208,351208
R188674,RED GAP HOLDINGS LLC,"BOLANOS,MARIA E",300000,650000,350000
R280340,PATHFINDERS HOMES INC,"CAPOBIANCO,DONATO C &",325000,675000,350000
R652883,VILLA HOME DESIGN LLC,"PEARCE,TOMAS &",201000,549900,348900
R139549,DEZ DEVELOPMENT LLC,"BETTER,DAVID K &",157000,505000,348000
R273022,"DUPEYROUX,FREDERIC &","WELLIVER,LOGAN",270000,616000,346000
R294755,RUBY NORTHWEST LLC,"HELWIG,JONATHAN A &",245000,590000,345000
R203572,"LEIPHON,DENNIS D","BROWN,HERSCHEL M &",475000,820000,345000
R203004,DILUSSO HOMES LLC,"HU,HONG-MING &",375000,720000,345000
R118854,GIBSON HOMES INC,"WINGFIELD,TINA",100000,445000,345000
R273553,"REILLY,JOHN K &","SHIN,MICHAEL S M &",276000,619000,343000
R230780,COMFORT RESTORATION INC,"RUFFENACH,COLLIN &",225000,565000,340000
R172530,BLAZER INVESTMENTS LLC,"FALCONE,ELIZABETH A",133000,472000,339000
R206522,CAMIN INVESTORS INC-75% &,"PENDERGAST,PATRICK J",250000,589000,339000
R230904,BGP VENTURES LLC,"SENGSTAKE,POLLIE",283055,622000,338945
R180190,EVERETT CUSTOM HOMES INC,"OSMAN,COREY D &",160100,499000,338900
R172807,BIG MOOSE DEVELOPMENT INC,"OLDS,BENJAMIN Z &",357500,695000,337500
R212154,"MCCULLOCH,JOHN","MORITA,TIMOTHY P",555000,890000,335000
R260927,PORTLAND DEVELOPMENT GROUP,"WALCHLI,JASON &",282000,615000,333000
R239471,"HOCH,DAVID","GOLAND,GLEN J &",6000,338500,332500
R184437,NORTHWEST LAND SERVICES LLC,"GOFF,BRIAN &",310000,640000,330000
R304712,RANDBER LLC,"HISATOMI,JAMES J &",502000,832000,330000
R288475,PEAR POINT INVESTMENTS LLC,"SLEESMAN,JAY B &",430000,760000,330000
R315208,PORTLAND DEVELOPMENT GROUP,"MICHAELIS,DAVID S &",170000,499900,329900
R169599,STEADFAST PROPERTIES LLC,"WOMMACK,BRANT D",130500,459900,329400
R233501,"TEKORIUS,DANIUS J","ZANT,KARYN E &",176000,505000,329000
R221200,ARNETT CONSTRUCTION CO,"LEHMAN,NILES E &",286000,615000,329000
R243213,"MEHR,JAMSHID TR &","PETRICKA,ELLIOTT",205000,532500,327500
R212409,"HAMBERG,GLENN E &","LINDBO,DARRELL T &",272665,599900,327235
R309384,LA JOLLA MJ MANAGEMENT II,"RUTHRUFF,JOSEPH ET AL",391000,717810,326810
R189307,"BURRIGHT,DEBBIE","LACY,PETER M &",260000,586000,326000
R260267,DILUSSO HOMES LLC,"HESS,JOLEEN M TR",339500,665000,325500
R152677,OLD TIME INVESTMENTS INC,"PARSHALL,ALLISON &",449900,775000,325100
R262530,"REILLY,JOHN K &","MCCLURE,IAN &",300000,625000,325000
R262530,"REILLY,JOHN K &","MCCLURE,IAN &",300000,625000,325000
R237544,RENAISSANCE CUSTOM HOMES LLC,"PRUDENCE,TIMOTHY",175300,500000,324700
R229196,BLAZER INVESTMENTS LLC,"BJORNSTAD,ROBYN &",151000,473000,322000
R117951,WILDE PROPERTIES INC,"WONG,ANDREW &",259900,580000,320100
R232770,"FRERES,ROBERT T JR","FRERES,HOLLY A",285000,605000,320000
R182794,PORTLAND DEVELOPMENT GROUP,PROPERTY OWNER,326000,645000,319000
R191172,MAYUCHI CAPITAL LLC,"LEHMANN,KRISTINE",350000,667000,317000
R226645,SEYMOUR GENERAL CONTRACTING,"SAMSON,THOMAS &",257160,573250,316090
R181869,"JONES,KENNETH L","TRAN,ANTHONY HUU",370000,685000,315000
R156636,WHEATSTRAW LLC,"BARTON,LINDA L &",360000,675000,315000
R168833,"HORNER,RODRICK","COWDEN,KENNETH M &",300000,615000,315000
R156732,"MIYAKE,JASON","MARTIN,ISAIAH S &",282250,593000,310750
R266451,RENAISSANCE CUSTOM HOMES LLC,"BOLSTAD,NICK &",390000,699900,309900
R276208,"SOROKOVSKY,ALEX &","SWARTZ,CHRISTINA &",162000,470000,308000
R143205,CITY REDEVELOPMENT2 LLC,"BRAMHALL,NAOMI F &",282000,590000,308000
R299701,"WEIGANDT,BRAD &","CASEBEER,MATTHEW M &",503000,809900,306900
R259336,PORTLAND DEVELOPMENT GROUP LLC,"HYLES,LISA J",400000,705000,305000
R259239,2514 NE 46TH AVENUE LLC,"VAKOUTIS,GEORGE R &",295000,600000,305000
R227332,FOGLIO HOMES &,"DILL,MATTHEW J",89250,393909,304659
R271373,EDEN ENTERPRISES LLC,EDEN ENTERPRISES RENTAL,443000,746812,303812
R177729,"VINCZE,JANOS L &","ROBERTS,CHRISTOPHER L &",326000,629000,303000
R187288,"WEIGANDT,BRADLEY &","EHLERINGER,JEFFREY H &",347500,650000,302500
R265967,RENAISSANCE CUSTOM HOMES LLC,"FARMER,KIRA &",115500,414900,299400
R149453,LA JOLLA MJ MANAGEMENT II,"BROOKS,JAYNA M &",430000,729000,299000
R200505,"WILSON,JAMES J TR","ORKIN,ANTHONY",459950,756500,296550
R128300,SAKURA HOLDINGS LLC,"SEIBLY,JOHN G TR &",1955000,2250000,295000
R190319,WHEATSTRAW LLC,"KELLEY,DAVID C",280000,569900,289900
R305756,1812 PARTNERS LLC,"AUGUST,NATHANIEL J &",274000,560000,286000
R115066,MACLEOD CONSTRUCTION INC,"GENZER,GARY L &",215000,499900,284900
R262266,"GERLACH,JON","ANDERSON,RYAN B &",290850,575000,284150
R153746,BRIAN MCMILLEN LLC,"KIM,JOSEPH J &",150000,433891,283891
R222075,CREO PROPERTIES LLC,"KAIHANI,ARMIN",152000,435000,283000
R147228,ASH PARTNERS LLC,"ENGBLOOM,JULIE M &",265000,547500,282500
R215803,LIBERTY NW HOMES LLC,"SCALDEFERRI,KEVIN &",250000,530000,280000
R125032,MCS1 LLC,"JACKSON,JUDY",122000,399950,277950
R312447,SHANNON ACQUISITION LLC,"JOHNSON,JEREMY &",252500,529900,277400
R165776,WHEATSTRAW LLC,"NYSCHENS,BETTIE L",215000,492000,277000
R263328,KLARAOS NEIGHBORHOOD,"SCHWINOF,KRISTINE M &",275000,551000,276000
R159732,"CONNELLY,MARK K &","SHURTLIFF,AARON &",120000,395000,275000
R177590,LIBERTY NW HOMES LLC,"CARLOS,BRETT A",350000,625000,275000
R222405,RED GAP HOLDINGS LLC,"THROWER,ETHAN J &",10,275000,274990
R124144,GREENLAND INVESTMENT,"THOMPSON,MARIA T &",151500,425000,273500
R177067,NSI INVESTMENTS LLC,"BERCELI-WAIN,JOSEPH &",500000,770000,270000
R281071,"GAMBLE,JACQUELINE I","HSU,CHIA YIN",225000,495000,270000
R294754,"HALPIN,FRANK","BREWER,PATRICK G &",190000,460000,270000
R203750,KC ACQUISITIONS LLC,"SORRELL,MATT &",421000,690000,269000
R303983,MODERN TRANSFORMATIONS LLC,"CABLE,BRADLEY J &",311900,579900,268000
R271347,BIG MOOSE DEVELOPMENT INC,"YOUNGREN,MARK A &",302000,570000,268000
R243784,HAIGHT AVENUE LLC,"MADDEN,SEAN R &",190000,457000,267000
R536612,"MATZKE,PETER","ELROD,CLAY A &",225000,490000,265000
R204978,PETEFARR LLC,"HUYNH,JASON",93000,358000,265000
R502621,"SEXTON,DON &","KACZMAREK,ERIC",370000,635000,265000
R280425,WILDE PROPERTIES INC,"TRAN,JERRY M",245000,510000,265000
R306270,"HOLLAND,THOMAS C &","BLACK,STEPHEN P &",360000,622800,262800
R212069,LAST MILE PROPERTIES LLC,"ST JOHN,JAMES L &",318000,579000,261000
R187995,"MC CULLOCH,JOHN D","SNYDER,SHERIDAN D &",635000,896000,261000
R152405,"GERINGER,JACK TR &","ROYER,DARA &",370000,630000,260000
R291102,TEAL DAVISON CONSULTING LLC,"KUENSTER,KENNETH H &",210000,470000,260000
R231719,CITY BAKING COMPANY &,"DOBRES,ROBERT &",230000,490000,260000
R117889,CADEN CUSTOM HOMES LLC,"ARMSTRONG,MARK &",275000,535000,260000
R184154,LIBERTY NW HOMES LLC,"LEO,LEANA E",230000,489900,259900
R113125,WILDE PROPERTIES INC,"BASS,AARON J &",440000,699900,259900
R218445,LIBERTY NW HOMES LLC,"REEDY,WILLIAM &",217500,474900,257400
R132019,"REILLY,JOHN &","HARTER,ERIC &",375000,632000,257000
R218098,BLUE PALOUSE PROPERTIES LLC,"ADAMS,TREVA M &",114750,369900,255150
R235010,EQUITY TRUST COMPANY CUST,"PORTER,KIMBERLY S",47500,300000,252500
R215127,"MCBEE,NATHAN","TAYLOR,TRAVIS &",128500,380000,251500
R220992,RUNNING WATERS PROPERTIES OF OREGON LLC,"SWEENEY,JOSEPH R &",325000,575000,250000
R202888,"SILVER,BENJAMIN","SLINGER,RYAN",415000,665000,250000
R203446,NORTHWEST ACQUISITION &,"POTTER,ERIC R",270000,520000,250000
R124083,"VOLKMAN,ROBERT A","WARD,PATRICK G &",291500,541400,249900
R290329,AAV1 LLC,"SOWIEJA,SHELLEY &",90000,339000,249000
R293176,LIBERTY NW HOMES LLC,"DAVEE,CHARLES R &",246560,495500,248940
R224512,CONSOLIDATED DESIGNS LLC,"TAYLOR,CARYN O",125200,372000,246800
R340287,GLADHEART LLC,"FISHER,DALE &",250000,495000,245000
R180381,"HUME,GREGORY R","WOOD,JUSTIN R &",240000,485000,245000
R103959,J2S PROPERTIES LLC,"HANDELMAN,CORINNE R",85000,330000,245000
R188806,PORTLAND DEVELOPMENT GROUP,"VIGGIANO,STEFANO M &",350000,595000,245000
R189169,"HORNER,RODRICK","HAYWARD,LINDSAY R &",355000,599900,244900
R211708,RUNNING WATER PROPERTIES LLC,"HOLMES,TYLER A &",150300,395000,244700
R101115,"BADALIAN,TINA M TR","WARD,STEVEN A &",320500,565000,244500
R135558,"LIBERTY,ALICIA &","ALLEN,PAUL T &",151000,395000,244000
R219209,SMILE PROPERTIES LLC,"COLLINS,FOREST R &",325000,569000,244000
R126375,WILDE PROPERTIES INC,"MISTRETTA,JESSICA S &",184000,425000,241000
R196574,"PEYRALANS,JEAN P &","SZUKALLA,VICKI",155000,395500,240500
R189014,"MAY,BEN","CHAPIN,STEVE E &",295000,535000,240000
R144372,AIM INVESTMENT SOLUTIONS INC,"EMMERSON,JENELLE M &",250000,490000,240000
R103716,"ROACH,ROBERT P &","HODSDON,WENDY &",200000,440000,240000
R156775,"HATHAWAY,KENT &","LOVE,ELAINE M &",260000,499900,239900
R180441,"JONES,KENNETH","SOUTH,STEVEN R",211000,450000,239000
R107139,TTM CAPITAL FUNDING LLC,"MCHAYLE,ROGER &",195000,433000,238000
R131007,"ANDREYUK,MICHAEL P","CHERVENY,JOHN E &",217000,455000,238000
R131007,"ANDREYUK,MICHAEL P","CHERVENY,JOHN E &",217000,455000,238000
R191925,"BATES,MARK R &","WESTGAARD,KEITH &",168000,405000,237000
R169646,"DANIELS,BLAKE","HAWKES,THOMAS",305000,541000,236000
R302824,GOLDLEAF PROPERTIES LLC,"RANGER,BRIAN &",202000,438000,236000
R142736,"CHAN,SUZANN","JONAS,FREDY",230000,465000,235000
R340287,GLADHEART LLC,"FISHER,DALE &",250000,485000,235000
R283275,ANTHONY RYAN LLC,"PADDEN,CHRISTINA",296000,530000,234000
R652867,PORTLAND DEVELOPMENT GROUP,"FRENNEA,KYLE &",366000,600000,234000
R223792,LIBERTY NW HOMES LLC,"WHEELER,GEORGE T JR &",105500,337500,232000
R217372,"PRICE,JORDAN &","MCCORMICK,MATTHEW B &",238360,470000,231640
R202161,"HALPIN,FRANK A","FREDRIKSEN,HEIDI M &",254125,485000,230875
R128099,"PACKWOOD,BOB &","MILLER,ERIC R",178000,408800,230800
R177578,PATHFINDERS HOMES INC,"KRISHNAN,BRINDA S &",305500,535000,229500
R203905,"GUSTAFSON,JON C","CHOWDHURY,MUNTAQUIM F",277000,506500,229500
R205365,WILDE PROPERTIES INC,"BANY,RACHAEL",230000,459000,229000
R222470,LMP ACQUISITION LLC,"FRANCIS,BRADLEY S &",149900,378500,228600
R212569,EMPOWER MANAGEMENT LLC,"VELAZQUEZ,YVETTE",307200,535000,227800
R330500,"ADAMS,DENNIS","WHILDIN,KRISTI E",132800,360000,227200
R240822,MULTNOMAH VILLAGE PROPERTY LLC,"GIBSON,GEORGE C",210000,437115,227115
R219788,"HAGER,ANTHONY","ROSENBERG,NEAL S &",202000,429000,227000
R301119,"MARTIN,ERIC &","JACOBSON,DONALD C &",185000,412000,227000
R308848,"MCELROY,ALENA","LAFAVOR,THERESA &",257000,483000,226000
R309788,"YORK,JOHN","COTTON,RYAN &",349500,575000,225500
R162353,"SHEETS,BRIAN &","LONGFIELD,JOHN W TR",220000,445125,225125
R309542,"MORTARA,NICOLE","DUDLEY,BRUCE S &",349900,575000,225100
R163764,ROHILLCO BUSINESS SERVICES LLC,"GRAHAM,SEAN M &",400000,625000,225000
R204705,"ARMBRUST,BRAD","MEADE,WILLIAM E",107000,330000,223000
R280730,WHEATSTRAW LLC,"MUSE,MARK W &",247000,469900,222900
R306817,WYNDYM DEVELOPMENT LLC,"CRAIN,KRISTIN B &",317500,539900,222400
R247897,BUILDING BLOCKS LLC,"BOENDER,STEVEN J &",227900,450000,222100
R224333,"MARTIN,ERIC &","RADLOFF,KNUT &",325000,547000,222000
R100879,"WEIGANDT,BRADLEY &","MCGRAW,TERRENCE T &",377500,599000,221500
R198340,EP VALOR,"WILLIAMS,KATHERINE R",304000,525000,221000
R312157,WILLAMETTE VALLEY,"VEUM,CYNTHIA &",90000,310000,220000
R124923,FULL HOUSE PROPERTIES LLC,"ASCHKENASY,RUTH H TR",270000,490000,220000
R107940,WHEATSTRAW LLC,"LIFTON,JOSHUA H",150000,368000,218000
R327548,"HOLLAND,THOMAS C &","FORMAN,KEITH A &",300000,517500,217500
R266801,"TEKORIUS,DANIUS","ASHMAN,DAVID A &",182500,399000,216500
R207911,CITY BAKING CO-1/2 &,"GARLAND,CRAIG D &",260000,475000,215000
R273432,"JONES,KENNETH","BAKER,CHRIS J",374000,589000,215000
R172529,CREO PROPERTIES LLC,"ARMIN,GOLNAZ",205000,419900,214900
R271350,"GARDNER,DARIN R","ANDREWS,JONATHAN S",210260,425000,214740
R141790,TEAL DAVISON CONSULTING LLC,"LACOUNT,MAKENZIE L &",410000,624000,214000
R160481,"SCHWARTZ,ED","WHITTEN,BRIAN &",240000,454000,214000
R211974,THE NOBLE INVESTMENT,"OLIVER,BRIANNA F &",329324,543000,213676
R291618,DEKA TALENTA INC,"FENSTER,LARRY L &",235000,447500,212500
R197743,"FEIBEL,SADIE","FENTRESS,JERROLD &",8114,220000,211886
R246938,CURTIS SOLUTIONS LLC,"SMITH,JEREMY A &",288900,500000,211100
R280643,"LENINGTON,DEREK &","DAVIS,ADAM &",499000,710000,211000
R239412,AAV ONE LLC,"NGUYEN,MINH &",80000,291000,211000
R122983,"HENDERSON,SETH W","FLYNN,DEVON",245000,455000,210000
R207464,METRO HOMES NORTHWEST LLC,"EVANS,CORINNE V &",200000,410000,210000
R102559,"GRIGORYAN,ROBERT &","KELLEY,SAM &",205000,415000,210000
R305052,"EDMONDSON,JEFF &","FULLEM,GREGORY D",280000,490000,210000
R225954,"JETTON,ERIC &","SWETTLEN,TIMOTHY M &",1040000,1250000,210000
R176616,DILUSSO HOMES INC,"WHITNEY,SUSAN Z",210000,419900,209900
R289359,RENAISSANCE CUSTOM HOMES LLC,"VOLPONE,WILLIAM S &",259950,469000,209050
R176108,"TAYLOR,MARK","PETERSON,E TYLER &",275000,483500,208500
R295426,"MAY,BEN","NATHMAN,HOWARD S &",232500,440000,207500
R189222,SHANNON ACQUISITIONS LLC,"ALLEN,LEONARD J",350000,557500,207500
R591049,THE ABLETON GROUP INC,"LABERGE,EDWARD",142000,348400,206400
R129205,ABLETON GROUP INC,"JUSTICE,CARLA N &",162301,368000,205699
R104240,JOHN STILWELL LLC,"HIGHTOWER,PAULETTA",250000,455000,205000
R210663,WILDE PROPERTIES INC,"HALL,SUSAN J TR",265000,470000,205000
R260038,"WATSON,STEVEN M","WELLS,JANIS &",270000,475000,205000
R202489,PORTLAND DEVELOPMENT GROUP,"HUGHES,ANDREW A &",420000,625000,205000
R134850,"KELLY,GEORGE &","FRANK,MARTI J &",310000,514000,204000
R272819,"TRAVER,JEFFERY H","LEBECK,BRIAN D &",135000,339000,204000
R308639,"HIBBEN,BRANDY","GILLARD,KELLY M &",105500,309200,203700
R330584,KAZCO OF OREGON LLC,"KLAHN,JUSTIN L",325500,529000,203500
R120477,"LARNER,COREY &","NGUYEN,THANH VAN &",85000,288000,203000
R203154,COHAESUS HOLDINGS GROUP 1 LLC,"HINCKLEY,JAMES H",277500,480000,202500
R133477,RED GAP HOLDINGS LLC,"SMITH,KYLE J",117600,320000,202400
R333161,OI PROPERTY INVESTMENTS LLC,"BENNIS,LORI",95000,297000,202000
R331394,KW REAL ESTATE CONSTRUCTION &,"NAKATO,TATSUO &",177500,379500,202000
R226475,LIBERTY NW HOMES LLC,"MILLER,THADDEUS R &",335000,535900,200900
R193873,WILDE PROPERTIES INC,"CARTER,DANIEL M",229400,430000,200600
R101443,PROPERTY ACQUISITION CORP,"FRY,MARTI L",424900,625400,200500
R307368,GOOD DAY LLC,"LAPLANT,NATHAN L &",245811,446000,200189
R137256,ROYAL CUSTOM HOMES INC,"APONTE,MICHAEL G &",210000,410000,200000
R248178,"FRANKLIN,MARK","UNVERDRUSS,EKKEHARD F &",225000,425000,200000
R247995,"KELL,JOANNE","MONICAYO,CRISSEL A &",235000,435000,200000
R218741,BIG MOOSE DEVELOPMENT INC,"GRIMMER,BENJAMIN D &",370000,570000,200000
R112175,HORIZON MANAGEMENT GROUP LLC,"PAI,SONA &",250000,449999,199999
R227451,"DANIELS,BLAKE","DE LATORRE,CAROL",227000,425000,198000
R282797,JT & LS HOLDINGS LLC,"WARNER,COLIN D &",255500,453000,197500
R283349,"HIBBEN,BRANDY &","STUART,ALAN &",332500,530000,197500
R181271,BIG MOOSE DEVELOPMENT INC,"INGLOVE,CATHERINE A",212900,410000,197100
R210737,LIBERTY NW HOMES LLC,"GINARDI,CRAIG",186000,381875,195875
R166339,"BATTAN,DEVIKA","MILANO,JOHN M &",45877,241000,195123
R295632,ENCIRCLE DESIGN & BUILD LLC,"KIMELDORF,LLOYD",215000,410000,195000
R319297,AIM INVESTMENT SOLUTIONS INC,"RHOADES,JANET K &",220000,415000,195000
R280796,DILUSSO HOMES LLC,"WOOD,ANDREW W &",225000,420000,195000
R316132,TEAL DAVISON CONSULTING LLC,"MILLER,CHARLES A",330000,525000,195000
R233464,WILDE PROPERTIES INC,"GARDNER,JOSHUA S &",270000,465000,195000
R291792,PORTLAND REDEVELOPMENT LLC,"PATTON,JOSHUA D &",220000,415000,195000
R228577,"BARRS,MICHAEL C","RUTJES,JULIE &",155570,350000,194430
R114016,"BURK,ROBERT","ANDERSON,CAROLINE",187500,381000,193500
R233721,MORRISON BUILT LLC &,"SORENSEN,PATRICIA E &",152000,345000,193000
R307071,STATHI'S STATION LLC &,"CARPENTER,ARLEIGH J JR &",345000,537500,192500
R226652,"LUCHINI,ALBERT A JR-1/3 &","LANFORD-CRICK,WILLIAM &",164230,356500,192270
R166645,LMP ACQUISITIONS II LLC,"ZEMAN,MATTHEW C &",480000,672000,192000
R657238,RENAISSANCE CUSTOM HOMES LLC,"MENDA,SAMEER",283000,475000,192000
R123612,ZEMP INVESTMENTS LLC,"LEWIS,JOHN K &",116000,307000,191000
R160067,PRESCOTT MORRIS LLC,"BAUMAN,CHELSI N &",109160,300000,190840
R222394,CLJF LLC,"LUDWIG,CORA",150000,340000,190000
R158082,"HAGER,ROBIN","ZACHARY,FOREST B &",80000,270000,190000
R168268,"GOODSELL,DARWIN","KENYON,RANDY &",225000,415000,190000
R259251,"KEPPINGER,KATHLEEN","SCOTT,CHRISTIAN &",625000,815000,190000
R211392,LAST MILE PROPERTIES LLC,"KNECHT,DAVID Z &",172500,361500,189000
R294563,"PAPWORTH,OWEN","THOMPSON,JEFFREY S &",160000,348500,188500
R136198,"TALAL,FAINA","BULBUK,IVAN &",66900,255000,188100
R166183,"KIMMETT,JON","STEWART,CHRISTINA A &",302000,490000,188000
R179840,WILDE PROPERTIES INC,"BOHMBACH,CHRISTI &",162000,350000,188000
R243616,"NEDELISKY,MICHAEL","SLIGH,ALBERT JR &",251000,439000,188000
R209513,URBAN HOMEMAKERS LLC,"HASSENFRITZ,PATRICK",248800,436500,187700
R290268,NSI INVESTMENT LLC,"SHERA,MATTHEW P &",170000,357000,187000
R308664,WILDE PROPERTIES INC,"PHILPOTT,CLAIRE",233000,420000,187000
R278555,"POZZI,KATHLEEN M TR","IRELAND,SUSAN &",350000,536710,186710
R260160,PAC SOLUTIONS LLC,"GIBBY,MEAGAN &",212500,399000,186500
R243330,"BUTLER,RHETT ET AL","LEISY,STEPHEN T &",218500,405000,186500
R248525,"MARKT,WILLIAM C","DINWIDDIE,JOSHUA D &",134000,320000,186000
R558005,THE ABLETON GROUP INC,"HUNT,HARLEY H &",160000,345600,185600
R248705,"CORAH,ALLAN &","HAMILTON,KEITH E &",135000,320000,185000
R211506,METRO HOMES NORTHWEST LLC-33.4% &,"WAGNER,CAROLYN",275000,460000,185000
R271341,ACCENT UPPER DRIVE HOLDINGS LLC,ACCENT HEIGHTS LLC,340000,525000,185000
R333012,"BRIGGS,CHRIS","PASCHILD,CRISTINE N &",210000,395000,185000
R257172,"SHTOGRIN,VLADIMIR","GUNNING,BRIAN &",365000,550000,185000
R306843,"JACOB,NICHOLAS A","MOLIMBI,LANDRY &",240000,425000,185000
R215154,AAV ONE LLC,"NGUYEN,CONG V &",115000,299900,184900
R131216,LIBERTY NW HOMES LLC,"KOVARIC,ALDER L &",190000,374900,184900
R100677,"MSCICHOWSKI,WILLIAM",WACHENBURG INVESTMENTS LLC,49950,234500,184550
R338497,"ROGELSTAD,DOUGLAS D &","PASEWALD,RUSSEL &",72000,256500,184500
R117945,WILDE PROPERTIES INC,"WARD,WESLEY T &",275000,459000,184000
R297898,PORTLAND DEVELOPMENT GROUP LLC,"PARKS,JACOB D &",235000,419000,184000
R163593,DIAMONDS IN THE RUFF PDX,"PARKMAN,IAN D &",199000,382555,183555
R135688,"WIRTA,STANTON","THOMS,ROBERT B &",165000,348000,183000
R312658,SKILL POINTS HUMAN,"CROWDER,ALBERT M JR &",205000,387500,182500
R253911,WILDE PROPERTIES INC,"HAGLUND,SUSAN M",177845,360000,182155
R196479,CAPO CONSTRUCTION INC,"ZIMMERMAN,JOHN &",154000,336000,182000
R145143,"GOUNER,BRANDON","GOUNER,FARLEY A &",153000,335000,182000
R211541,"POWELL,ANDREW P","TYREE,JAMES T",220000,402000,182000
R106566,SEYMOUR GENERAL,"LIVINGSTON,TIMOTHY J &",168000,349900,181900
R265815,"DOVGAN,PAVEL JR","HORNER,MICHAEL S",138000,319900,181900
R295136,"AYERS,JAMES W","ZIETZ,ERIK &",250000,430375,180375
R180260,RED GAP HOLDINGS LLC,"HANSON,ERIC",201000,381000,180000
R155843,"NIMZ,MARK T",Sale In Progress,219450,399000,179550
R226602,"KHOO,SIOK PUAY","WESTER,BARRY",298799,478000,179201
R229203,STRATANCE LLC,"BODIN,ROBYN &",180000,359000,179000
R159144,"DAVIS,RICHARD D &",WOODSTOCK PROFESSIONAL,181500,360000,178500
R189741,"TAYLOR,MARK","EDLUND,AREN D &",177000,355500,178500
R127781,JJT3 LLC,"BATTE,CHRISTOPHER &",220000,398000,178000
R241761,EQUITY DEVELOPMENT GROUP LLC,"MULLINS,ABBY",90000,267450,177450
R184806,"YOUNGE,ROBERT TR &","PLESKO,WILLIAM",78000,255000,177000
R140144,"OLSON,SCOTT",Sale In Progress,106000,282800,176800
R140144,"OLSON,SCOTT","CROWELL,STEPHANIE O &",106000,282800,176800
R127258,"JONES,KENNETH","BADER,MARJORIE L",261900,438500,176600
R118639,KERR PACIFIC COMMODITIES,"HOFFMANN,MICHAEL G &",212500,389000,176500
R295568,LIBERTY NW HOMES LLC,"LUCHT,NICHOLAS R &",224000,399900,175900
R216575,WILLAMETTE VALLEY,"SWIFT,KAREN A",265000,440000,175000
R207257,"BOCK,GEORGE S","KENNEDY,JILL A",164500,339500,175000
R307625,ORACLE DEVELOPMENT LLC,"JOUNO,DANIEL &",225000,399900,174900
R303914,"MEINERS,JON &","FITCHETT,DONALD S &",393000,567500,174500
R189806,"BURTON,DEREK E","MOCK,ADAM G &",316000,490000,174000
R175442,"GUNDERSON,CHRIS","CANTON,ANTHONY B &",485000,659000,174000
R112431,"GRECO,LEONARD &","MOORE,LOUIS E",221900,395000,173100
R318612,"BALDWIN,BARBARA","THAYER,MARK S &",162500,335000,172500
R115680,"JANSEN,JONN I","ESTERBERG,ELIZABETH J",76000,248500,172500
R292519,NSI INVESTMENTS LLC,"HARVEY,FRANCES E &",177500,350000,172500
R329170,"KNUDSEN,DOUGLAS E &","SPITZENBERGER,ANN",313000,485000,172000
R565601,JDR PROPERTY INVESTMENTS LLC,"STEWART,NELSON &",150000,322000,172000
R106676,"MCBEE,NATHAN","STEWART,CHRISTOPHER M",178000,349000,171000
R259640,"HORNER,RODRICK","ROCHA,JULIE A",114000,285000,171000
R108643,WILDE PROPERTIES INC,"WALDOCK,K MICHAEL &",225000,395800,170800
R152793,EVERETT CUSTOM HOMES INC,"BOWMAN,JEFF &",529000,699500,170500
R207006,"DEAL,TIMOTHY","LOWE,ALLISON S",214650,385000,170350
R207006,"DEAL,TIMOTHY","LOWE,ALLISON S",214650,385000,170350
R198189,"PARKER,KATHRYNE C &","MILLS,RICHARD T &",280000,450000,170000
R197332,"SCHINIK,TAL TR",DAVID & TIA EMMITE,355000,525000,170000
R593609,"CRABTREE-SCOTT,WYATT M","SUNDERLAND,KYRIN",10000,180000,170000
R102850,"HAMILTON,JANET L &","KONDRAT,ANGELA",269000,439000,170000
R203791,"WAMPLER,SAM","LOUGH,DANA &",415000,585000,170000
R120928,BIG MOOSE DEVELOPMENT INC,"ELLIOTT,JORDAN C &",180000,350000,170000
R258088,"TERPIN,DAVID J &","ALVAREZ,BRITTANY M &",505000,675000,170000
R113218,"THODOS,JUDITH","ROMEREIN,KAY",400000,569500,169500
R212685,UNISON HOMES LLC,"ROSS,EDWARD M",50000,219500,169500
R297613,"HUYNH,TINA","HUYNH,JULIE",80000,249050,169050
R209293,MY FINANCIAL WORKOUT LLC,"BRIMA,AHMED &",120000,289000,169000
R228465,EWCP TS FUND LLC,"O'CONNOR,MICHAEL G &",196000,365000,169000
R219989,"CHAMBERS,JASON M","MARTIN,SARAH E &",330000,499000,169000
R185766,AAV ONE LLC,"BROOKE,JOHN T &",191000,359256,168256
R315272,MORRISON BUILT LLC &,"URBANC,ANNA M &",177001,345000,167999
R228461,THREE QUARTER TIME,"GEIST,STEPHEN A &",190000,357500,167500
R251250,HIGHLAND HOLDINGS LLC,"MULLER,ERIC E &",149000,315000,166000
R294901,"BUCK,ROD","WALL,BRYAN J",201000,367000,166000
R248691,"LAYON,CHRIS","ELS,BRIAN J",150000,315000,165000
R114668,"CONNELLY,MARK &","CECCHINI,JEFFREY L &",170000,335000,165000
R253763,"BUI,KHANH Q","RAKHA,SHAMEEM",140000,305000,165000
R138445,RED GAP HOLDINGS LLC,"HINMAN,CHELSEA A",230000,395000,165000
R243719,D A S DEVELOPMENT LLC,"JOHNSON,SARAH E &",365000,530000,165000
R303626,THE NOBLE INVESTMENT,"MURPHY,GEORGE A",260000,424999,164999
R198255,"RISSI,JOHN B &","SODERBERG,CHRISTIE L &",535000,699900,164900
R233403,"OSTERGAARD,EBEN &","CHAN,WENDY &",225600,389000,163400
R172776,"CARVER,WILLIAM L &","FICEK,RYAN",177000,340000,163000
R305823,"PLATT,ROBERT","MOTT,THOMAS D &",152500,315000,162500
R181936,PATHFINDER'S HOMES INC,"HAGEDORN,GINA K &",367500,530000,162500
R267469,COLUMBIA REDEVELOPMENT LLC,"ELLIOTT,ANDREW &",277960,439900,161940
R313748,"SMITH,PETER W &","ROSSON,BRET M &",158500,320000,161500
R199065,"HELLEBRAND,JANA","CORBETT,J KEVIN &",218500,380000,161500
R103060,BRIDGETOWN EQUITY,"EAGLE,TARA L &",236550,398000,161450
R207347,"CALVIN,ALICE R","STOLZ,PETER &",327500,488900,161400
R224529,J & D RENOVATIONS LLC,"EDMONSON,STERLING C",90000,251000,161000
R139250,DREAM HOME RENOVATIONS LLC,"EBERZ,CHRISTOPHER J",240000,401000,161000
R248898,"TRAVER,JEFFERY H","JONES,BRENT",105000,266000,161000
R264045,KOKER INC,"CALVERT,KERRY R &",149000,310000,161000
R123687,"LEE,SHERWIN","EVENS,DANIEL",99000,259900,160900
R653431,"CONNELLY,MARK &","TON,PHAT D &",90000,250000,160000
R200231,"FRANCE,CLAYTON G &","GOLDBERG,JAMIE B",629000,789000,160000
R293103,"HOLLAND,THOMAS C &","WENDLER,IAN &",425000,585000,160000
R279444,"BALLANTYNE,DONALD L &","TUKE,SCOTT D ET AL",400000,560000,160000
R331213,BIG MOOSE DEVELOPMENT INC,"PRICKETT,LELAND &",185000,344900,159900
R139024,"NEDELISKY,MICHAEL &","BEARDSLEY,STEVEN J &",165000,324900,159900
R308785,"GALAGUROV,ALEKSANDR","KOPKIN,JEFFREY A &",175500,335000,159500
R264060,"WIRTA,STANTON A","KNIPE,THOMAS &",185000,344000,159000
R239927,"LAYON,CHRIS","TRALLE,KELLEY M",212000,371000,159000
R176508,"HOLBROOK,GILLIAN","HASSON,ELON",250000,409000,159000
R183964,"VALLE,CECILIA","STARK,AMELIA &",88000,246500,158500
R180111,"BUTLER,ZANDY","REAMES,MICHAEL D &",189900,348000,158100
R241544,JONAY PROPERTIES LLC,"ARMAGOST,IVY BETH",222000,380000,158000
R178237,"STROMME,MARK","LEMATTA,CLAIRE C",555000,713000,158000
R242085,KIMCO PROPERTIES LTD,"HENDERSON,KEVIN R &",210000,367500,157500
R331277,CONSOLIDATED DESIGN LLC,"BOAK,RAMSEY M &",142000,299500,157500
R190240,PORTLAND DEVELOPMENT GROUP,"LINDSAY,JOSEPH A &",239000,396000,157000
R178090,"SCOTT,RAY","REID,JAMES M &",133000,289900,156900
R229288,"TRAVER,JEFFERY","SANDVIG,NATHAN",140050,296800,156750
R303522,GREENWING RESTORATION,"HITCHCOCK,STEPHEN W &",142000,298500,156500
R104474,SEYMOUR GENERAL CONTRACTING,"ZABROCKI,KATHERYN &",73100,229400,156300
R190057,GEZA DEVELOPMENT LLC,"CATHEY,ERIC J &",273800,430000,156200
R319002,"LI,WEI HONG","LOVE-JONES,IAN &",94800,250000,155200
R200694,"SEARS,SUSAN M","BECIC,STEVEN J &",410000,565000,155000
R167598,"HAMPTON,JAMEY C &","TURNER,JOHN B &",970000,1125000,155000
R273818,BKB INVESTMENTS LLC,"DEVEREAUX,LANCE &",175000,330000,155000
R308791,DILUSSO HOMES LLC,"CHANG,AMBER C &",170000,325000,155000
R114732,"CONRAD,DAMIAN J &","SIKORA,RICHARD &",255000,410000,155000
R109717,"STIPE,ROBERT","BORGES-SILVA,CHRISTOPHER M",92515,247450,154935
R124002,PATHFINDER'S HOMES INC,"STEELE,ERIC A &",430000,584900,154900
R279324,LAST MILE PROPERTIES LLC,"VAN DEGRAAF,DEREK S &",222500,377400,154900
R240600,EDEN ENTERPRISES LLC,"HILLESLAND,LYNSEY &",245000,399900,154900
R203169,"O'KIEF,WILLIAM","LENHART,RICHART L TR",165000,319900,154900
R317966,"COURCEY,KEVIN &","HERZBERG,DEBORAH",299000,453600,154600
R313739,"MARKMAN,SHAWN","STROM,DAVID M &",186000,340000,154000
R277502,MODIFI LLC,"SLOANE,ROBERT &",115000,269000,154000
R117372,"BREITSTONE,LINDA","KORNFELD,AVNER &",875000,1029000,154000
R306899,DILUSSO HOMES LLC,"TIPTON,COLT",196100,350000,153900
R272811,OI PROPERTY INVESTMENTS LLC,"SHERWOOD,ANDREW A &",163500,317000,153500
R188809,DILUSSO HOMES LLC &,"HINTZ,STEPHANIE C",302000,455000,153000
R264104,"VAKULSKY,VASILY","THOMAS,KANE",115000,268000,153000
R114549,KLARAOS NEIGHBORHOOD,"MOLIKEN,WARREN ET AL",291000,444000,153000
R172208,URBANSCAPE LLC,"NEWTON,NARAYAN &",147000,300000,153000
R321841,FLORENCE DESIGNS LLC,"MORRIS,MICHAEL R",52000,204900,152900
R226998,"SULLIVAN,TRACI","HUNTER,JOAN M &",180000,332000,152000
R159319,"REBER,EVA","FREEBURG,NATHAN &",400000,552000,152000
R167402,DEKA TALENTA INC,"GOSS,KIMBERLY L",218000,369900,151900
R115651,"KIM,JOSEPH","LIMA,LORI ANN &",95000,246000,151000
R124634,DREI 2300 LLC,"GODSON,OSCAR C &",165000,315850,150850
R165635,NSI INVESTMENTS LLC,"MCPHERSON,MATTHEW R &",374605,525000,150395
R176500,"SYVERSON,JODI J","GEORGE,MATTHEW &",380000,530000,150000
R228170,"BROWN,DENNIS &","ABUZIED, ELNAZIER H",150000,300000,150000
R502635,"PRICE,MICHAEL &","HOWARD,RICHARD A",1050000,1200000,150000
R224822,AAV ONE LLC,"YU,KIN KI &",80000,230000,150000
R305767,"KONDZIELA,KEN JR","GAERTNER,DONA S &",230000,380000,150000
R283832,WILLAMETTE VALLEY,Sale In Progress,120000,270000,150000
R118916,"MILLS,TONY","BROWN,MICHAEL S",190000,340000,150000
R551268,"HAZZARD,FRED &","ASP,ERIC A",235258,385000,149742
R280796,MCHUG LLC,DILUSSO HOMES LLC,75400,225000,149600
R296165,"MCBEE,NATHAN","BOYER,CARLY",200000,349000,149000
R180075,"BEAUDOIN,JOEL K","CHARUHAS,ADAM T &",201000,350000,149000
R187936,"DIANI,CHRIS A &","GRIFFITHS,DANIEL P &",505000,653870,148870
R157581,"MAJORS,JACK B","REDFERN,JOSHUA R &",108000,256500,148500
R261353,"KATZ,LORIN R &","FORD,HARRY T",137000,284500,147500
R249507,J AND D RENOVATIONS LLC,"WEAVER,JACQUELYN &",92500,240000,147500
R294588,J B HAMMER COMPANY INC,"CARSILLO,MARY ANN &",309000,456500,147500
R261353,"KATZ,LORIN R &","FORD,HARRY T",137000,284500,147500
R134364,BIG MOOSE DEVELOPMENT INC,"KELLY,ALTA &",187950,335000,147050
R134364,BIG MOOSE DEVELOPMENT INC,"KELLY,ALTA &",187950,335000,147050
R203730,"MCCARRON,JESSE A &","WEYMANN,DAVID F &",515000,662000,147000
R207305,"RASCHE,LINCOLN","IRWIN,ZARETH &",183000,330000,147000
R152525,"HILDRETH,PATRICIA J","GOW,JACK A &",398200,545000,146800
R300642,"DODD,MICHAEL T &","REED,DONNA L",194000,340000,146000
R294283,"ROBINSON,BRYAN D &","GORDON,SEAN N &",302000,448000,146000
R576996,"PARKER,GEOFF","STEVENS,TREVOR E &",150000,295600,145600
R248385,"DAPP,BRIAN",EDEN ENTERPRISES RENTAL,166000,311500,145500
R214659,M R HANNA PROPERTIES LLC,"POWELL,BRITTANY K &",251000,396500,145500
R295553,"WESTHUSING,WILLIAM M &","HOWES,CELIA A &",444600,590000,145400
R160427,KLARAOS NR 9-OR13 LLC,"CARLOS,ROBERT JAMES P",249748,395000,145252
R160000,"CAMPOS,DUSTIN","HEBERT,NATHANIEL J",105000,250000,145000
R146089,"BUCK,ROD L","MATERNE,NICOLE S &",265000,410000,145000
R188668,PEAR POINT INVESTMENTS LLC,"KELLER,THOMAS W &",215000,360000,145000
R264034,PORCHLIGHT PROPERTIES LLC,"SCHUMACHER,JOHN C &",205000,350000,145000
R277158,SWS LLC,"MIYAKE,MITSUKO",125000,269900,144900
R306634,"BOYACK,LORI","GARCIE,MICHAEL L &",230000,374800,144800
R193859,WILDE PROPERTIES INC,"BELLINGHAM,BRYANT K &",251500,396000,144500
R183272,PETEFARR LLC,"GRECO,MARK P",122500,267000,144500
R231942,MATILDA LLC,"ADLISH,RACHEL N",109900,254400,144500
R204653,FABRYCKI HOMES INC,"MARTEL,LISA",112000,256175,144175
R283241,DREAM HOME RENOVATIONS LLC,"KIMBROW,RACHEL E &",413000,557000,144000
R190200,"KILPATRICK,ANDREW C &","ALLEN,KENNETH &",212000,355900,143900
R342374,"SESTER,TED G","SNYDER,LESLIE R &",104000,247500,143500
R191070,RED GAP HOLDING LLC,"WEINGART,NEAL &",236750,380000,143250
R291029,"SCHWARTZ,ED","CHILDERS,DAVID V",192000,335000,143000
R252995,SHELBYVILLE PROPERTIES LLC,"DUFFY,REGAN M &",242000,385000,143000
R229183,"KNODE,KIPP","PORESKY,AARON &",256000,398900,142900
R113902,PORCHLIGHT PROPERTIES LLC,NE 65TH AVENUE LLC,261000,403500,142500
R154000,EFFICENS DEVELOPMENT LLC,"DORANTES,JORGE",218000,360000,142000
R259156,STEINER REMODEL LLC,"KUPERS,JULIE D &",287500,429500,142000
R250954,"JAKO,TAMAS JANOS","SONODA,RICHARD &",165000,307000,142000
R290137,"EXALL,WILLIAM B","TALL,DEREK A &",183000,324950,141950
R124865,HERMES BROS LLC,"NICHOLSON,JONATHAN",198300,340000,141700
R245740,MODERN TRANSFORMATIONS LLC,"BHOJWANI,HEMAN R &",131000,272500,141500
R101901,"BAILEY,SUSAN V &","WARWICK,ALEXIS M",215000,356000,141000
R195863,"MINDERHOUT,THOMAS A &","WEINGER,GREGORY S &",308400,449000,140600
R193810,WILLAMETTE VALLEY,"CRUDEN,ALISON T",225000,365500,140500
R279929,HIGH CARB LLC,"KEYES,JAMES C",142500,283000,140500
R206629,"MONTI,ALLISON","STEVENS,NANCY M TR",197600,338000,140400
R269274,"GARNER,VIVIAN J &","CARTER,THOMAS V",219900,360000,140100
R193634,"MADDIGAN,JOHN J","LAMADRID,DAVID &",229900,370000,140100
R225834,BKB INVESTMENTS LLC,"KUPETZ,CHARLES J",100000,240000,140000
R156561,"BUTLER,RHETT ET AL","SCHUSTER,DUSTIN A &",275000,415000,140000
R172709,"MAY,BEN","KOCHIS,STEPHEN C",160000,300000,140000
R284451,ENCORE DEVELOPMENT,"MAN,SOPHIA &",180000,320000,140000
R324740,"VANTULDEN,ROBERT &","HANMER,JEREMY",485000,625000,140000
R227642,DIAMONDS IN THE RUFF JHC INC,"RUIZ,JORDAN &",240000,379900,139900
R133080,"KIRK,DIANA &","BARTZ,CRYSTAL L &",120200,260000,139800
R176144,KEZA LLC,"CHOI,DINAH &",371250,511000,139750
R163535,EVERETT CUSTOM HOMES INC,"POTTS,JAMES &",310500,450000,139500
R157950,PAC SOLUTIONS LLC,"COLEMAN,CORY &",165500,305000,139500
R226215,"HESS,MARY M TR &","TARASOFF,NICOLE M &",260590,400000,139410
R173869,REAL PROPERTY MANAGEMENT CORP,"LINDGREN,ANN M &",89900,228900,139000
R209270,"HAMILTON,JANET &","CAROLAN,TIMOTHY A",131500,270500,139000
R277208,"CLARK,JOSEPH H","TOBEY,JILL C",220000,359000,139000
R189911,WILLAMETTE VALLEY,"HEINO,JASON J ET AL",249500,387900,138400
R245216,STERLING RESIDENTIAL LLC,"WEST,BRETT A &",165000,303200,138200
R297145,"DANIELS,BLAKE","JONES,KENNETH",213000,351000,138000
R213931,"KIRKLAND,TAMRA J","HICKS,KARISSA &",265000,403000,138000
R575870,HOMEAGAIN RENOVATIONS INC,"HENDEL,GABRIELLE &",127000,264950,137950
R299220,"FOSTER,SHALISAN L","ROWAN,DANIEL L &",312250,449950,137700
R196608,JTC PARTNERS LLC,"MORGENTHALER,JEFFREY A",129000,266000,137000
R331423,JACAL LLC,"LONG,MORGAN R &",358000,495000,137000
R107633,"BEAM,DARRELL","PROVOST,EMILEE A",118000,255000,137000
R288873,"ABRAMS,CHRISTOPHER","LARSON,RYAN &",232000,369000,137000
R242118,"PELLEGRINI,TERI L","POTLAPALLY,NACHIKETH R &",100000,236512,136512
R166308,"MCBEE,NATHAN &","PLATANIAS,HEATHER A",84000,220500,136500
R130750,"HARRINGTON,MICHAEL A","LANEY,ZACHARY R &",270000,406500,136500
R121948,"WHITT,JOHN J","BOCK,PAUL O &",388500,525000,136500
R206305,BOONDOGGLE LLC,"TALMADGE,KEVIN &",162550,299000,136450
R162180,EDEN ENTERPRISES LLC,"SUZUKI,DALE &",204000,340000,136000
R220794,"HINCKLEY,DAVID B","LAMBERT,ERIN &",94000,230000,136000
R152898,"CALLAHAN,LISA M","PINAIRE,BRIAN K &",530000,665000,135000
R102182,WHEATSTRAW LLC,"DUBUISSON,ANDREW C",172000,307000,135000
R204843,"DOPP,STEVE &","KAHL,KATRINA",125000,260000,135000
R166107,"KULLEY,MARLOWE","EDMAN,STEPHANIE &",260000,395000,135000
R245447,"TRAVER,JEFFERY","SUTHERLAND,THOMAS &",115000,250000,135000
R113750,HISTORIC REVITALIZATION LLC,"CAPPS,JOSH &",252500,387500,135000
R157078,"TALLMAN,LEE J &","RUDE,COHN M",130000,265000,135000
R245114,PORTLAND DEVELOPMENT GROUP,"HOGLUND,DIANE M",80000,215000,135000
R152898,"CALLAHAN,LISA M","PINAIRE,BRIAN K &",530000,665000,135000
R198422,HILLSIDE SENIOR SERVICES INC,"CROWELL,KIMBERLY M",400000,535000,135000
R310559,"BONDARENKO,VITALIY","YAN,SONG FENG",115500,250000,134500
R300396,BRADLEY INVESTMENT GROUP INC,"DORMAN,MARY E &",187900,322000,134100
R191319,"SCHROEDER,JOANNE","ATHMANATHAN,BHASKAR &",85000,219000,134000
R320021,STREAMLINE INSPECTIONS INC,"HELD,MARION",146000,280000,134000
R143169,"PERRIN,PATRICIA C","RUBIN,KENNETH M &",294000,427500,133500
R311582,"WILLIAMS,ALAN","PETERSON,JENNA",181500,315000,133500
R299531,"PERKINS,J MARK",AF HOESLY INC,192000,325000,133000
R174709,"HIJ,VIOREL","COLBERT,ROBERT A",127000,260000,133000
R195185,"PELLEGRINI,TERI L","BALO,CHRISTOPHER M &",102000,235000,133000
R292189,"GALAGUROV,ALEKSANDR","MAY,BRIAN",142000,275000,133000
R214892,PRESCOTT MORRIS LLC,"MIRECKI,LAUREN E",171500,304000,132500
R119783,"SAKER,NAEL","BURTON,THOMAS",85000,217500,132500
R195041,PREFERRED TRUST CO CUST,"HASKINS,MARGARET",166800,299000,132200
R155519,BLEECKER & PERRY LLC,"COOK,CHRISTINE M",255000,387000,132000
R230910,TRUE BREAD PROPERTIES INC,"BORGERSON,LEBAHAN C &",50000,181675,131675
R196400,JET INVESTMENTS LLC,"SAVAGE,MATTHEW M",225000,356500,131500
R107784,"PELLEGRINI,TERI","NOLDE,ELIAS R &",150000,281500,131500
R108230,FREDERICK G SHERVEY,"GOH,CINDY MUI-JOO-50% &",150000,281300,131300
R251621,"GOLDEN,DON","CROSBY,VALERIE J",63900,195000,131100
R324096,KW REAL ESTATE CONSTRUCTION &,"ROGERS,LEWIS C",155125,286000,130875
R248784,"WIRTA,STANTON A","SWINEHART,JACKIE E",151820,282500,130680
R280654,CONTINENTAL FINANCIAL INC,"TANPINCO,DENNIS M",179850,310000,130150
R273863,TOP NOTCH RENOVATIONS INC,"RAJKUMAR,DEVARAJ",150000,280000,130000
R240909,WILLAMETTE VALLEY,"CLOKE,ALICE C",305000,435000,130000
R160072,"FENNELLY,JOHN","CHILDS,GLEN D &",122000,252000,130000
R225825,"REED,DOUGLAS K","AVILA-SERNA,VERONICA",75000,205000,130000
R276946,"HANSEL,CARLA &","BROWN,BENJAMIN &",315000,445000,130000
R315492,MAYUCHI CAPITAL LIMITED,"WONG,NONNIE",110000,240000,130000
R303167,"PIPPEN,BRAD W D","GARCIA,ELIZABETH &",94500,224300,129800
R243686,"MCBEE,NATHAN","ALEXANDER,JENNIFER &",256000,385000,129000
R167787,"KAZAKOV,SERGEY","HAMPSHIRE,AARON L &",120000,248972,128972
R209051,DIAMONDS IN THE RUFF PDX LLC,"HASKINS,TIMOTHY M &",230000,358500,128500
R336084,"KAZAKOV,SERGEY","PHILLIPS,ERIC G",130503,259000,128497
R336084,"KAZAKOV,SERGEY",Sale In Progress,130503,259000,128497
R304031,"COPUS,JEFFREY D &","FLETCHER,BRADFORD H",400000,528300,128300
R151671,"MUNTER,MICHAEL D","ZERBY,SVITLANA &",157000,285000,128000
R289364,"MALONEY,MICHAEL","ANDERSON,CHARLEY",165000,293000,128000
R253739,"JOHNSON,AMY","BERNARD,ROBYN",62000,190000,128000
R304630,"ROHOSY,ADAM &","LANAHAN,BRIAN J &",740000,868000,128000
R520797,"THANA,GEORGE &","GFAFFARI,ABDUL R",107500,235000,127500
R226193,COTD III LLC,"YOUNG,DANIEL R",160000,287500,127500
R191187,BLEECKER & PERRY LLC,"COCHENER,DEANNA M TR",365000,492500,127500
R325765,"PRIEST,PATRICK","FRIES,VALERIE J",209500,336875,127375
R106429,"ROLLS,DANIEL J","WINTRINGHAM,CHAD W &",146000,273200,127200
R147699,DEKA TALENTA INC,"LEDBETTER,STACEY",130000,257200,127200
R249719,EDEN ENTERPRISES LLC,"PUSTER,JOHN F &",313750,440900,127150
R172885,VILLA INC,"RANTA,MIKA D",201900,329000,127100
R194474,THORNTON PROPERTIES LLC,"KATELHUT,DIONE",289900,417000,127100
R106402,"BUZEY,SERGEY","HASHAM,ERIC H &",113000,240000,127000
R223544,"WATKINS,TRAVIS &","JOHNSON,ALICIA &",360000,487000,127000
R206356,"STIEVENARD,DEBBIE","RODER,MARC A",150000,276900,126900
R253671,"ADAMS-MESSMER,SUSAN &","DEVOY,CAITLIN",148400,275000,126600
R141670,"NEW,TERRY","LETOVSKY,JOHN M &",623500,750000,126500
R140250,"CHRISTENSEN,R W TR","SMITH,KATHERINE E",115000,241500,126500
R319347,"CHANSON,JAKE","BEAN,LISA L",237500,364000,126500
R104804,"HELLEBRAND,JANA","HARBERSON,ASHLEY",158000,284000,126000
R275657,JDR PROPERTY INVESTMENTS LLC,"HINSHAW,MATTHEW J &",166100,292000,125900
R327570,"BORN,CHARLEAN &","MULLANEY,SUSAN E &",763200,889000,125800
R159095,"DO,HOC VAN &","GEORGES,DANAE",124500,250000,125500
R217129,"HELLEBRAND,JANA","ALLEN,JORDAN G &",89650,215000,125350
R284658,"MOBLEY,STEVEN E","COLLAZO,MICHELLE E &",119950,245000,125050
R215926,WILLAMETTE VALLEY PROPERTY,"LAMBERT,GLORIA",275000,400000,125000
R155326,DILUSSO HOMES LLC,"STAFFORD,CHRISTOPHER &",150000,275000,125000
R536613,"HALLIBURTON,DONALD","VALENTINE,REX B &",255000,380000,125000
R103991,STERLING RESIDENTIAL LLC,"KLEIN,CHARLES H",100000,225000,125000
R249428,"STANKOVIC,DAVID","KATTARI,LOREN &",175000,300000,125000
R141802,"KENNARD,THOMAS G &","CHELLIS,MICHAEL R &",550000,675000,125000
R130697,FLAGSTAFF CAPITAL LLC,"FENWICK,JEANNIE T",315000,440000,125000
R338562,"FISAL,SAMIYAH","BRISTOL,DENNIS M &",75000,200000,125000
R282873,"POLITES,CHRISTIANA &","HUPART,SAMUEL",180000,305000,125000
R536640,"MATZKE,PETER N","GROTTING,DONALD L &",317000,442000,125000
R318999,FRONTIER DEVELOPMENT INC,"TRUONG,THUY DUYEN V",135000,260000,125000
R341880,"GIBSON,STEVE L","GIBSON,STEVEN L JR",105000,230000,125000
R180624,"KELL,JOANNE","JALO,RAYMOND L &",102000,227000,125000
R553586,"GASSNER,RICHARD E","ANNIS,ERIN L &",115000,239900,124900
R131302,"PERRIN,PETER M","SMITH,JEFFREY &",275000,399550,124550
R280359,PWM GROUP LLC,"EMERSON,BRENT A &",230000,354000,124000
R248994,ZEMP DEVELOPMENT INC,"SPENCER,CLINTON E &",161000,285000,124000
R172331,"LE,DIEM","HELLER,CHARITY",87000,211000,124000
R174881,"TSARENKO,SERGEY &","HINZE,KARIN E &",141300,265000,123700
R340710,"MORTON,ROBERT &","CASS,KAMI D &",89900,213500,123600
R180112,"SPEVAK,ELI","VANDEPAS,MARTIN",198500,322000,123500
R305789,"POIRIER,JERRY","LINT,ADAM S &",268000,391000,123000
R248832,COTD III LLC,"CLARK,AARON S",180000,303000,123000
R209292,"GRIFFITH,PATRICIA J &","GEIGER,DEANNA &",177500,300000,122500
R329715,"CHAN,SUZANN","NEMETH,EMILY S",146611,269000,122389
R213208,"FISHER,WILLIAM","HOLT,SARA",251000,373000,122000
R304244,"FRIEH,SHANNON &","WALHOOD,BRADLEY C &",295000,417000,122000
R132554,"JACOBSON,ROY","SWARTOUT,DARYL R &",266000,388000,122000
R245275,"WIRTA,STANTON","FLANIGAN,SHAWN D &",70000,192000,122000
R294851,HOMEAGAIN RENOVATIONS INC,"WILDER,KATHLEEN",150000,272000,122000
R139243,SPP PROPERTIES LLC,"MALKASIAN,IAN &",215000,336900,121900
R498875,"SAKER,NAEL &","BROOKINS,ERNEST R JR",83200,205000,121800
R178602,J2S PROPERTIES LLC,"PARK,LAURIE",100000,221000,121000
R178761,"ARMBRUST,BRAD","POORE,GIA",92000,213000,121000
R330204,JACAL LLC,"HAYS,KYLE E &",371000,492000,121000
R108908,BOONDOGGLE LLC,"MCKAY,JOHN C",65000,185130,120130
R218334,GOOD FAMILY REAL ESTATE LLC,"GARNER,CLINTON &",90000,210000,120000
R253714,"LIGHTCAP,ANDREW","DUFFIELD,GARIN",205000,325000,120000
R290929,MACH PROPERTIES LLC,"GONZALEZ,SHAWNEEN M &",255000,375000,120000
R104672,"RIDER,LAURA L","HEDIN,DAVID C",171000,291000,120000
R266476,BARTHOLEMY CONSTRUCTION,"WILLIAMS,DEVON A &",255000,375000,120000
R142607,E STREET INVESTMENTS,"BONG,KOESMANTO L",210000,329900,119900
R188929,"STOLERMAN,IRINA","LUENGO,ANIKA D &",370000,489900,119900
R136889,ELITE RE INVESTMENTS LLC,"MCGOWAN,CHARLES",115689,235000,119311
R231986,"HAUCHILD,NANCY J &","MORGAN,MARY K",179900,299000,119100
R191612,ENCORE DEVELOPMENT,"TALBERT,CHRISTINA L",80000,199000,119000
R279988,SEYMOUR GENERAL,"GOLFIERI,GABRIELLE",79100,198000,118900
R196764,"BAGLEY,SHIRLENE","MELES,TSEGAW &",82000,200000,118000
R196661,"MEYER,JAMES &","PORTRAIT,DANIEL &",182000,300000,118000
R303372,DUBCO INVESTMENTS L L C,"PHILLIPS,BRETT C &",268500,386500,118000
R300823,BRIDGETOWN EQUITY,"GALAVIZ,MARIAH J &",189000,307000,118000
R266115,"EDMONDSON,JEFF","BOOTH,JACK W ET AL",175000,293000,118000
R115081,PROPERTY ACQUISTION CORP,"D'ALOISIO,LYNNE M-85.4% &",292500,410500,118000
R196299,"GREGORY,JOEL R &","PETERSEN,RYAN T &",237000,354900,117900
R197146,"MACCALLUM,MITZI K","SCHWENKE,RICHARD &",109900,227500,117600
R284524,SKILL POINTS HUMAN,"GARBARINO,KELLY",217500,335000,117500
R252993,"DILLER,LYNNETTE","KACZYK,MARGARET F &",250000,367500,117500
R243717,"REGISTER,PATRICK &","MC GHEE,KIMBERLY S &",177000,294330,117330
R333876,"PHAM,MARY &","ADAMS,LA TRINA",88000,205000,117000
R222396,DREAM HOME RENOVATIONS LLC,"BRIGHT,LAURA G",211000,328000,117000
R279653,"CLAPA,BENJAMIN","BASS,JAMES D &",120000,237000,117000
R300709,"LAYON,CHRIS","FEROLIE,ELLEN &",133000,250000,117000
R138758,"NEDELISKY,MICHAEL J &","BEARD,STEVEN T &",137000,254000,117000
R572935,HEYBURN LLC,"SOSA AGUILAR,ARTURO I &",133000,249900,116900
R261939,"CHEN,YI JING","LEWIS,HANNAH M",99000,215400,116400
R298574,"MEILI,KRISTA &","HALL,TIMOTHY M",116000,232000,116000
R191040,"EDMONDSON,JEFF","SO,KHEMARITH &",140000,255400,115400
R289665,TTM CAPITAL FUNDING LLC,"MCCUNE,LOGAN &",104625,220000,115375
R290868,"PEIA,LOREEN P","RUNTZ,SUSAN E",259900,375000,115100
R554505,"ESTAKHRIAN,JAHANGIR &","POPE,CHRISTOPHER",410000,525000,115000
R124388,"CAMERON,BRAD &","JOHNSON,BENJAMIN G &",115000,230000,115000
R290393,"HEINER,CHARLES","JOHNSON,DAVID A &",295000,410000,115000
R283161,"WAMPLER,SAM","WALKER,LINDA A",620000,735000,115000
R131388,STEELHEAD CONSTRUCTORS INC,"GEE,TODD W &",230000,345000,115000
R208054,"AUSTIN,DAVE","CULP,MATTHEW E &",105000,220000,115000
R214331,MAYUCHI CAPITAL LLC,"HANNAH-JONES,NIKOLE S &",145000,260000,115000
R131388,STEELHEAD CONSTRUCTORS INC,"GEE,TODD W &",230000,345000,115000
R158068,"SPIGAL,RACHEL","CORWIN,CARYN E &",115000,230000,115000
R126310,WINNING REALTY LLC,"HONAKER,JENNIFER",130000,244978,114978
R114304,"NGUYEN,HOANG V &","KURKINEN,SAMUEL J &",190000,304900,114900
R207570,HJ 185 LLC,"PAYNE,JOSHUA W &",165000,279900,114900
R295359,T4T LLC,23RD STREET STORE LLC,200450,315000,114550
R278674,DONALD P NELSON REALTY CO,"HOLLOMAN,DEAN D",150000,264500,114500
R174073,"RASCHE,LINCOLN","BOTTINELLI,AMY M &",165500,280000,114500
R155529,"DENBURG,SCOTT R","BRACKEN,CAMERON",202500,316900,114400
R199914,OREGON REAL ESTATE,"BORING,DAVID &",92200,206500,114300
R275123,"BOYER,WILLIS","CRANFORD,JOHN W &",101000,215000,114000
R186243,BELLA INVESTMENTS LLC,"SKARE,STEVEN J",227000,341000,114000
R159147,"FEENEY,JAMES M III","JUSTICIA,RACHEL A &",68000,182000,114000
R162971,AAV ONE LLC,"SMITH,SHOUMEI",85000,199000,114000
R210947,"GOLDEN,DON &","HAINES,KIM D",85500,199500,114000
R292720,"ABRAMS,CHRISTOPHER","PLINSKI,BRIAN W &",251000,365000,114000
R289574,"MEHR,JAMSHID TR &","FREY,RICHARD W &",170000,284000,114000
R290061,"HENDERSON,SETH W","KELLY,RYAN",150000,264000,114000
R189502,"TERJESON,SHERI","MCIRVIN,TREVOR S &",131250,245000,113750
R122795,PDX RENOVATIONS LLC,"BOEKEE,DIRK-JAN &",306500,419900,113400
R303976,BLEECKER & PERRY LLC,"STEPHENS,ELIZABETH &",265800,379000,113200
R241570,STEINER REMODEL LLC,"BOLENBAUGH,JOSEPH M &",175000,288000,113000
R164097,"KARAM,AKEL &","NYGARD,ROXANNE F",87000,200000,113000
R154562,"MILLER,GARY L &","SEID,RAYMOND H &",165000,278000,113000
R288427,"LUCK,DIANE","BAEK,ALEXANDER K &",335000,448000,113000
R139264,"EDWARDS,PAMELA J","SCOTT,NATHAN S &",210000,322500,112500
R317988,"MAY,BEN","HAYES,PAUL",129000,241500,112500
R186644,JT & LS HOLDINGS LLC,"MAYHEW,KARL &",217500,330000,112500
R229083,"PRIEST,PATRICK","CAIRNS,JAY T",195000,307100,112100
R590319,"KIMMETT,JON","JEWELL,ALEXA R",73000,185000,112000
R277082,CONSOLIDATED DESIGNS LLC,"MURDOCH,KYLE R &",140000,252000,112000
R222562,SEYMOUR GENERAL CONTRACTING INC,"HALL,RUTH E &",128000,239900,111900
R222562,SEYMOUR GENERAL CONTRACTING INC,Sale In Progress,128000,239900,111900
R308002,"FRIEDMAN,SIDNEY M &","PISCITELLO,ERNEST S &",570000,681500,111500
R164488,"BIXEL,JAMIE L","JARNAGAN,TIMOTHY S TR &",134751,246000,111249
R317683,"COLEMAN,CHET","SHIPRACK,JULIE ANNE",75000,186000,111000
R202981,"MESCHI,MOHAMMAD &","KING,PHILLIP",175000,286000,111000
R187171,BLUE HOMES LLC,"MORALES,MAVEL &",119000,230000,111000
R250358,"BUCK,ROD L","MCKERCHER,KRISTY",259000,369900,110900
R155329,"WATERS,ANNE",PENNYMAC LOAN SERVICES LLC,190000,300826,110826
R150994,"GALAGUROV,ALEKSANDR","DAVIS,SOFIA",105500,216000,110500
R232020,RACKLIN RENOVATIONS LLC,"MEEK,TAYLOR J",129500,240000,110500
R236084,"YODER,KAREN","MCDANIEL,THOMAS R",141000,251500,110500
R339062,"FITCH,DANE","AMES,STEVEN M",65000,175000,110000
R186898,KOKER INC,"RUEDINGER,LAURA E",109000,219000,110000
R277123,"MARTIN,ERIC &","ERVIN,ALBERT JR &",140000,250000,110000
R331271,"DEEGAN,LINDA","MARTINSEN,BENJAMIN P &",15000,125000,110000
R115040,"WHEATLEY,WILLIAM R-50% &","SMITH,GEOFFREY K &",345000,455000,110000
R169230,CAREY & CAREY REAL ESTATE,"JOHNSON,GWYNN R",115000,225000,110000
R144114,"CARVER,WILLIAM &","NIGGEMANN,JESSICA C",165000,275000,110000
R171945,PHAM REI-OR LLC,"FOSTER,ERIN L &",160000,270000,110000
R164089,"TAI,PING YEN","JIMENEZ RAMIREZ,GUADALUPE",110000,220000,110000
R277257,"NUNEZ,FERNANDO &","HUDSON,VICKIE G",150000,259900,109900
R162079,"OLSON,JOHN D","O'HANLON,CARRIE A",90000,199900,109900
R308786,THE SHOPS AT BROOKLYN YARD,"LEIPZIG,JONATHAN A",240000,349900,109900
R172213,"FOTEFF,TIM","JAMES,JELENA &",90000,199500,109500
R286924,"WEDDLE,JEFFREY S","WEDDLE,CHELSEA H &",100000,209500,109500
R129975,"KARAM,AKEL &","PHAM,ANDY &",88000,197000,109000
R178805,"KELLEY,RUSTY L","SYREYSHCHIKOV,VLADIMIR &",35000,144000,109000
R226568,"SONSHEIN,MICHAEL E","BUTZER,SCOTT L",125000,234000,109000
R241424,CASH FLOW INVESTMENTS LLC,"PAYNE,BARTON",123000,232000,109000
R144173,"MOON,DEBRA S &","WHITNEY,MOLLY E",118000,227000,109000
R109406,"MORGAN,STUART","JUSTICE,MICHAEL J &",191000,300000,109000
R107898,"CONGDON,CAROL P","SODERLIND,SPENCER D &",185000,293900,108900
R107897,VINTAGE PROPERTIES NW LLC,"NASH,LEHAH G &",135000,243900,108900
R174898,"TAMAYO,MAC","CUSHING,JOSHUA E &",97000,205500,108500
R197650,BIG MOOSE DEVELOPMENT INC,"WILLETT,CLAIRE",86000,194000,108000
R332290,"DODGE,RICK G","MACDONALD,EMILY J &",85000,193000,108000
R165811,VISIONARY HOMES INC,"NGUYEN,NGA",47000,155000,108000
R254291,SE CONSTRUCTION LLC,"HABRE,JOEL E",77000,185000,108000
R267543,"CORVI,THOMAS &","GAMBER,DANIEL R &",322000,430000,108000
R190440,"KIEF,WILLIAM O","LEE,JOSH M &",232000,340000,108000
R201456,"NASH,SCOTT","VALENTINE,JARED &",112000,220000,108000
R209283,"NALEWAY,ROCH","JONES,ERIK S",128000,235500,107500
R210051,"YOUNG,TIMOTHY","PEDERSEN,MARTIN &",210000,317500,107500
R197119,"GRECO,LEONARD R &","MAPOLSKI,CASSIE R",127575,235000,107425
R263618,"HIJ,VIOREL","GABEL,MATTHEW B &",102500,209900,107400
R249761,"STARR,BECKY A &","HENNESSY,MAUREEN A",161800,269000,107200
R335820,EQUITY TRUST COMPANY CSTDN,"SUMMERS,TIFFANY &",95000,202000,107000
R164451,WEST COAST DEVELOPMENT,"LONGSTREET,BECK O &",203000,310000,107000
R212988,PENSCO TRUST COMPANY CUST,ALBERTINA KERR CENTERS,172000,279000,107000
R184347,"SEELY,MIKE","SIMONS,DAVID",143000,249900,106900
R144123,"FARIS,CAROLYN M","PHILLIPS,JAMES R",111000,217500,106500
R144123,"FARIS,CAROLYN M",Sale In Progress,111000,217500,106500
R232328,"TANSILL,DOUGLAS F","JOHNSON,KAITLIN TR &",171000,277500,106500
R283618,HTD & ASSOCIATES LLC,"SHANKY,JAKE &",180000,286500,106500
R217011,K J ARR ENTERPRISES,TRUE BREAD PROPERTIES LLC,40000,146000,106000
R302362,"RASCHE,LINCOLN F","ROBSON,JAY",144000,249900,105900
R232359,VN CONSTRUCTION INC,"CALDWELL,NICHOLAS T",94225,199900,105675
R164047,"NAVARRO,JOSE","HERMENS,TIMOTHY G &",77000,182500,105500
R167777,"PEYRALANS,JEAN P &","KERSHAW,MARA A",101500,207000,105500
R336261,"COLEMAN,RANDALL C &",EDEN RENTAL DIVISION LLC,170000,275000,105000
R304938,DAL PROPERTIES LLC,"DIEHL,JOANNE D",170000,275000,105000
R298031,CHERRY TREE INVESTMENTS,"O'DONNELL,ERIN E &",215000,320000,105000
R198937,"GUSTAFSON,DANIEL J","CAMERON,DONALD",220000,325000,105000
R114613,"MINDERHOUT,THOMAS A &","MCFADDEN,CAROLYN A &",395000,500000,105000
R107540,"MARTIN,ERIC &","OESTREICH,JERRY D &",175000,280000,105000
R154910,"TIDWELL,JENNIFER L","GISCOMBE,TARA R &",150000,255000,105000
R151780,LAKESIDE LUXURY HOMES INC,"LA DICK,PAMELA M",122000,227000,105000
R120516,OCEAN EQUITY GROUP LLC,"JOHNSON,PENNY D",70000,175000,105000
R148210,STAI ENTERPRISES INC,"EGLE,JASON J",285000,390000,105000
R517234,"NIELSEN,KENNARD E &","WILKINS,ANTHONY J JR TR &",690000,795000,105000
R122483,"CONNELLY,MARK &","BROWN,ISABEL A &",120000,225000,105000
R334762,"WEISGRAM,FERDINAND &","YOURCHEK,JOSEPH Y",65000,169900,104900
R234043,"RAMSEUR,KATIE &","HWANG,DUNCAN &",175000,279900,104900
R237992,BLUE HOMES LLC,"WILLIAMS,ROBERT G &",177000,281500,104500
R252314,"SPARKS,ROBERT A JR","RICHARDS,WILLIAM E &",125500,230000,104500
R276251,"LEONG,PAK","ORTA,SOPHIE A &",93000,197500,104500
R121562,PROPERTY OWNER,"MONTALVAN,GUSTAVO R C &",75500,180000,104500
R228970,"GOODSELL,DARWIN L","HUBACK,PATRICIA",146000,250200,104200
R195963,WILLAMETTE VALLEY,"ATTLESON,INGRID",170705,274800,104095
R242841,"LINTON,PAUL W &","ERDAHL,RONALD R &",391000,495000,104000
R204548,"SHELDEN,MATHEW","ROSLIE,RYAN M &",140000,244000,104000
R264462,"PRIMACHENKO,OLEG","KATCHER,KAREN K",135500,239500,104000
R187148,"CONNELLY,MARK &","ROBERSON,PATRICIA",83500,187000,103500
R128511,"SCULLY,BENJAMIN P","RHEE,TAE JUNG TR",632000,735000,103000
R318431,"KAZAKOV,SERGEY &","BALCAZAR-CASTILLO,JORGE",120020,223000,102980
R126397,"BETTLES,BYRON &","YOUNG,HEATHER",242000,344900,102900
R266342,CREO PROPERTIES LLC,"MORR,JAMESON R &",175000,277850,102850
R128237,"TOMPKIN,JOANNA",WELLS FARGO BANK NA,349000,451793,102793
R265766,PATHFINDERS HOMES INC,"TRAN,HUAN THANH &",180000,282000,102000
R216893,"TAM,MEI TO","RODARTE,YADIRA H &",70000,172000,102000
R160004,RP & ASSOCIATES,"WALLS,LOUISE C",138100,240000,101900
R208923,MAYUCHI CAPITAL LLC,"BENNETT,CARRIE A",98000,199900,101900
R311056,"CRISTUREAN,CORNEL","WILLIAMS,HEATHER",97000,198750,101750
R169095,"HELLEBRAND,JANA G","COX,MONICA TR",125000,226500,101500
R133269,"EDMONDSON,JEFF","RASKAUSKAS,JESSE L",95000,196500,101500
R573881,"NASH,SCOTT F","LEONARD,MARK T &",85000,186500,101500
R194997,"FONTENOT,LOUIS JR","STAVA,CONNOR J &",146600,247900,101300
R167767,"JOHNSON,WILLIAM &","HUMMEL,HOLLY",125100,226256,101156
R213610,"ZHU,MENG","HOPKINS,AMANDA",155000,256030,101030
R181273,"OTLEY,KENNY ET AL","DUFFIELD,GREGORY S &",163000,264000,101000
R294261,"SEELY,MICHAEL &","WEBB,COLLEEN M",149350,250000,100650
R218622,"RUSSO,JOSEPH","KANZLER,JENNIFER",86948,187500,100552
R126316,"MCBEAN,KELLY M","ABELL,JAMIE J &",99000,199500,100500
R338598,"CHAN,FUK WING","PRANZETTI,NICHOLAS F &",94500,194800,100300
R300335,KEYSTONE RENOVATIONS LLC,"LILLY,WHITNEY V",140000,240025,100025
R177015,"PENNINGTON,ROBERT P","LEEDOM,TIMOTHY G &",640000,740000,100000
R244290,"NGUYEN,TUAN ANH VU","WANG,DING DING",70000,170000,100000
R128236,"STEWART,ROBERT B &","ROME,AMI M &",479900,579900,100000
R291789,"BOYER,P CHRISTOPHER &",METRO HOMES NORTHWEST LLC,245000,345000,100000
R292798,"WIRTA,STANTON","SEED,NICHOLAS M &",85000,185000,100000
R317463,"VAN DER LAAN,EMILY","VAN DER LAAN,RICHARD G",110000,210000,100000
R237250,"ANDERSON,CARY","YOSUF,AHMEDDIN A &",175000,275000,100000
R340991,"HAYDEN,TIMOTHY J &","BIRD,BRANDON S &",165000,265000,100000
R135899,"IVANOV,VITALIY","COUSER,ROY W &",170000,270000,100000
R263804,"KEPPINGER,JAMES T-50% &","MCDERMOTT,JAMES N &",600000,700000,100000
R254851,"NAPIERSKIE,SHERRIE E TR &","NGO,QUANG &",125000,225000,100000
R142753,BLANDENA LLC,"SCHMIDT,KATHRYN E &",210000,310000,100000
R257266,HEYBURN LLC,"PERRIN,PATRICIA C",149000,249000,100000
R286947,"CLARK,MATTHEW A","MOSTER,JAMES C",115000,215000,100000
R293090,LAKESIDE LUXURY HOMES INC,"BOYER,EITHNE M",130000,230000,100000
R136591,DILUSSO HOMES LLC,"GAFFNEY,ANGELA P &",170000,269999,99999
R300468,"HAMBERG,LEON G","WITKA,MARY B",160199,260000,99801
R195991,"KILYUKH,VLADIMIR","ANDREWS,DASONTA L &",120500,220000,99500
R154071,J & D RENOVATIONS LLC,"DEWILDE,JAMES R",74000,173000,99000
R178828,"ZHU,LI &","TRUJILLO,ROBERT M",100000,199000,99000
R340278,"MILLS,TONY","BAIN,JASON S",126000,225000,99000
R173575,"BERCHTOLD,JAMES J","BERCHTOLD,BRIAN J",357500,456500,99000
R180853,DILUSSO HOMES LLC,"COWAN,FABIK &",146150,245000,98850
R120669,"ERSKINE,BRANDI","DAWSON,MICHAEL A &",122500,221000,98500
R307910,"O'SULLIVAN,ARTHUR","CRAVEN,MATTHEW &",486300,584500,98200
R183278,"CARVER,WILLIAM L &","WAITE,JOSEPH &",146900,245000,98100
R171265,EQUITY TRUST CO CSTDN,"GURUSINGHE,ROCHELLE &",95000,193000,98000
R273257,"JONES,MICHAEL S &","FALLOW,ANN MARIE C",305000,403000,98000
R144124,"CRAFT,KENNETH","ROBERTS,CLANCY &",135000,233000,98000
R275187,"RASCHE,LINCOLN","BUTTRELL,JOHN L &",102000,199900,97900
R103510,"HOLMAN,MICHAEL","NGUYEN,TRUONG",121001,218888,97887
R225992,"HOANG,CHUNG VAN",EASTCO DIVERSIFIED,80500,178000,97500
R145157,"MAW,GAIL S","BUFFINGTON,JERRY L",101800,199000,97200
R224568,WILDE PROPERTIES INC,"ROMERSBERGER,RONALD L",120000,217000,97000
R200041,"LAFERRIERE,DANIEL S &","BOONE,JEFF M &",65000,162000,97000
R108105,"KARIN,DAMIR","HARPER,JACOB R",60000,157000,97000
R173671,"STURN,BENJAMIN","TRACHSEL,TONY R",162000,259000,97000
R338256,"TURCAS,NICOLAE","VATHEUER,HANS J EST OF",68500,165000,96500
R290589,"BURNETT,CURTIS","GILLMOUTH,PAUL J JR",75500,172000,96500
R170493,REFORMA LLC,"BENNETT,JENNIFER M",68500,165000,96500
R222278,"FRIEH,SHANNON &","ALAN,DAVID &",220400,316500,96100
R231143,PDX RENOVATIONS LLC,"HARRIS,TERRANCE J",135000,231000,96000
R143819,STAI ENTERPRISES INC,"BROETH,CHERISE R",140003,236000,95997
R211026,BIG MOOSE DEVELOPMENT INC,"HIBBS,GILLIAN Y",159000,254900,95900
R268787,"PINJUV,GUY","BUSCH,JORDAN S &",559500,655000,95500
R123607,"PELLEGRINI,TERI L","PEDERSON,LAUREL",72000,167500,95500
R216184,BUILDING BLOCKS LLC,"BRADY,MICHAEL",209800,305000,95200
R136040,"LOFORTI,CECILIA I","GIORDANO,LORRAINE",153000,248000,95000
R236027,"CHAN,NORMAN W &","GORNY,NORMAN F",150000,245000,95000
R215016,"KASSEBAUM,RICHARD A &","PERRIN,PETER M",405000,500000,95000
R289490,LAKIN + HANSEN LLC,THE BOYS AND GIRLS AID,320000,415000,95000
R119748,"FARIS,CAROLYN M",BENSIONI LLC,125000,220000,95000
R120650,"ARMBRUST,BRADLEY","DRAGOON,TRUDY",80000,175000,95000
R289612,RED GAP HOLDINGS LLC,"HANSON,BRENDA &",90000,185000,95000
R224279,VINTAGE PROPERTIES NW LLC,"CHANEY,DAVID D",130000,225000,95000
R546261,"VAKULSKY,VASILIY &","GALLIEN,SCOTT H &",150000,245000,95000
R234133,"RUDE,COHN","FLYNN,JOHN R &",260000,355000,95000
R130073,100 ACRE PROPERTY LLC,"NEVILLE,MALINA O",119900,214900,95000
R292384,MILLER POND LLC,"BURNETT,JERRY",190000,285000,95000
R197183,"PELLEGRINI,TERI","CROOK,CAROL E",65000,160000,95000
R271824,"RENNAKER,JASON","CASTEEL-BUTLER,LINDA S &",55000,149900,94900
R144187,"MCBEAIN,KELLY","SMITH,WILLIE B",135200,229900,94700
R135809,DREAM HOME RENOVATIONS LLC,"PARKER,JOSEPH P",120350,215000,94650
R274170,"BAY,JACQUELINE","HOPKINS,BRIANNA",113500,208000,94500
R117381,EDEN ENTERPRISES LLC,"TYNAN,MICHAEL A &",255701,350000,94299
R120160,"BLOMMER,MICHAEL B","BERGMAN,BRETT R",184900,279000,94100
R293523,"LIN,HE YOU",WESTSIDE COMMUNITY FOCUS INC,150000,244025,94025
R290639,"WONG,TIMOTHY W","CRAN,JOHN A &",79000,173000,94000
R332355,HOUSE MAGIC INC,"CLARK,JOHN &",135000,229000,94000
R131897,"HVAL,BRETT","HAWKINS,ALAN &",106000,200000,94000
R240197,"CRISTUREAN,ALEXANDRU","JONES,QUEEN E",70000,164000,94000
R120647,"QUAN,ALEXANDER","HOLT,JEFFERY S",86000,180000,94000
R212094,"HASH,CARRIE","NISHIMOTO,MICHAEL",290000,384000,94000
R122193,AGEE HOLDINGS & INVESTMENTS LLC,"MORRIS,JOSHUA D",90000,183950,93950
R113596,HISTORIC REVITALIZATION LLC,Sale In Progress,161500,255000,93500
R113596,HISTORIC REVITALIZATION LLC,"WILTON,JESSICA R",161500,255000,93500
R220076,"HESSON,RALPH","SENDERS,JULIE &",179900,273200,93300
R204347,"BLUHM,RICHARD W",LUDLOW PROPERTIES LLC,213000,306148,93148
R119018,"CAVETT,MARY","SHIMMIN,JOEL C",232000,325000,93000
R220283,"LOMBOS,JAIME R &","CATTLIN,OLIVER J &",102000,195000,93000
R249446,"CAPLENER,JIM","MOYER,MEGAN M",132000,224900,92900
R137854,"POPE,MATTHEW L","FALKOV,ALEXANDER &",157000,249900,92900
R206330,GADZOOKS! GARDENING INC,"GETTLE,JEFFREY A &",172000,264700,92700
R186465,"BURLEIGH,CAROLYN M","KITTAMS,JULIE A",200000,292500,92500
R210015,"CLAUDIO,JESUS","ROUSSEAU,STEPHEN &",67500,160000,92500
R121710,"VILLARREAL,JAMES A","ROSABAL,VERONIQUE",52500,145000,92500
R187081,FRANK INVESTMENT GROUP LLC,"KING,AURELIA M",93500,185740,92240
R175087,WILLAMETTE VALLEY,"ROBINSON,JOHN G",153000,245000,92000
R232598,"CREVER,CHRIS","PRIESTLEY,DAVIS &",135000,226600,91600
R190313,"COONEY,P PATRICK &","OLSON,ERIN K",200000,291500,91500
R178609,CAREY & CAREY REAL ESTATE,"SCAFURI,KATHERINE &",134000,225000,91000
R332316,"HASCALL,RICK","THOMPSON,TAMMY S",144000,235000,91000
R153658,COMPLETE REMODELING LLC,"COX,DONNIE R &",104000,195000,91000
R283652,GOLD LEAF PROPERTIES LLC,"DRISCOLL,WILLIAM B &",91000,182000,91000
R272902,BTR PROPERTIES LLC,"MORTON,JOAN M",109000,200000,91000
R266088,"BARRY,PATRICIA K","ORCHARD,SUSAN L &",268000,359000,91000
R241957,TTM CAPITAL FUNDING LLC,"GAY,ANGELA S",114000,204700,90700
R115119,"MILOT,JENNIFER &","YOUNG,TRAVIS &",651000,741500,90500
R152192,RIVER CITY M&M; LLC,"BROWN,MICHEL J &",75600,166000,90400
R178806,SEYMOUR GENERAL,"DOWNER,ELKE L &",99750,190000,90250
R209082,WILLAMETTE VALLEY,"MONTAMBO,SARAH M &",171778,262000,90222
R158759,"IIAMS,CARL","ALLINSON,ROBERT T IV &",307000,397200,90200
R257405,"PETERSON,DOUGLAS &","CAMP,ANDREA L",229900,320000,90100
R142564,"MADDIGAN,JOHN","WESTFALL,JOHN P",269950,360000,90050
R309965,"BARTELL,JEFF","TANIGUCHI,MITSUHIRO &",92000,182000,90000
R181520,"GRIGORYAN,ROBERT &","ELDER,SCOTT H &",135000,225000,90000
R330427,"NASH,SCOTT","KINGSELLA,DAVID &",209000,299000,90000
R178464,"VAN,HANH TRAN THIEU DIEN","VAN,MATTHEW T &",100000,190000,90000
R106611,DRAGONFLY HOLDINGS LLC,"SPENGLER,ANN O",90000,180000,90000
R215042,"CARDANO,CELSO","GOODENOUGH,LESLIE",80000,170000,90000
R248603,PRESCOTT MORRIS LLC,"BONONI,STEPHANIE &",122000,212000,90000
R146615,"EDMONDSON,JEFF","RENWICK,CASEY J &",90000,180000,90000
R211006,K-PAX LLC,"BROOKS,JOHN W &",128000,218000,90000
R293520,"NASH,SCOTT","DEFRISCO,JAMES &",120000,210000,90000
R236501,MK INVEST P01 LLC,"SHOEMAKER,TIMOTHY M &",115000,205000,90000
R337957,"LIN,AMY","KLEIN,JEREMY M &",64000,154000,90000
R156935,"PIPGRAS,MARTIN &","NOURSE,AMY D &",97000,187000,90000
R220732,RESTORATIONS BY K & C,"BRIGGS,SEAN",110000,199999,89999
R151752,PETEFARR LLC,"RUDDELL,MATTHEW A",100000,189950,89950
R250210,SILVER POINT PROPERTIES,"FAULKS,JAMES HERBERT &",149950,239000,89050
R195810,WILLAMETTE VALLEY,"KNOTT,AARON D",199950,289000,89050
R200815,"HARTMEIER,MEL","WELSH,MARCUS D &",220000,309000,89000
R261991,LMP ACQUISITION II LLC,"NIXON,DIANE E",110000,199000,89000
R142897,"WEST,NATHANIEL E &","OLIVER,DANIEL J &",355000,444000,89000
R575540,ZSD CONSTRUCTION INC,"KELLEHER,KEVIN F &",260000,349000,89000
R261705,"NGUYEN,NGOC M","PETERSEN,JONATHAN",100050,189000,88950
R290339,"PATTERSON,GEORGE &","MIREL,SUSANNA",124000,212925,88925
R241939,"DECKER,LESLIE","KELSAY,AMELIA B",125000,213800,88800
R208820,"ROBERTS,KATHIE L","PETERSEN,ROGER J &",166500,254900,88400
R337974,"MURO,JUAN","CUEVAS,JESUS M",61716,149900,88184
R228876,"TRAVER,JEFFERY","JENNY,LEE A",97000,185000,88000
R336658,"OUYANG,SHUN HAO &","BURGIN,ERIC C",92100,179900,87800
R121998,"LOPEZ-CERUTTI,OSCAR G &","ENG,ANNE J",139900,227500,87600
R297111,"LEVESQUE,STEPHEN P &","PERINI,JOANNA T",455000,542500,87500
R155604,EDMUND LEE LLC,"FICK,NATHAN D &",232500,320000,87500
R294615,PERFORMANCE HOMES LLC,"MCKENZIE,CLIFFORD H &",202000,289500,87500
R186309,"KUHNAU,RON","KUHNAU,LISA D",232600,320000,87400
R131873,"HANSEN,CARL D &","TONKS,TROY &",81900,169300,87400
R297239,"CREVER,CHRIS","COOPER,REBECCA &",136405,223500,87095
R232608,"DUNNING,LAURA","GENNARO,JAIME &",155000,242000,87000
R145946,GOOD FAMILY REAL ESTATE LLC,"LABRADO,SHAWN M &",73000,160000,87000
R170173,"SANCHEZ,KIMBERLY R","BALLARD STRAUHAL,MATTHEW J &",211000,298000,87000
R148062,"ROHRBACH,HAROLD","BRADLEY,DANNY A &",338000,425000,87000
R180676,"MAGSTADT,KAREN K","EVANS,MARGARET L",158000,245000,87000
R337977,"GERGALO,PAVEL A","HOEFT,WARREN M",108000,195000,87000
R155069,"MC DONALD,CLAY","OLSON,SCOTT K &",185000,272000,87000
R178500,"LAMARR,JOHN A &","BLACK,DAVID T &",90000,176900,86900
R223556,"SCHNEIDER,JOSH &","SCHREIBER,MARY K &",378400,465000,86600
R292423,"GOOSTREE,RICHARD D","FERGUSON,JENNA A &",138500,225100,86600
R260511,"DRUMMOND,WILLIAM K &","MASON,ANDREW &",563500,650000,86500
R194003,"MAYFIELD,DONNA","DAVENPORT,ROBERT A",172500,259000,86500
R290468,"SIMONSON,JEFFREY D","WESTERFIELD,ANDREA S",123375,209500,86125
R105725,"KLOSS,SHIRLEY TR","WEBSTER,DEVON R",145000,231000,86000
R236067,HIGHLAND HOLDINGS LLC,"MCCALL,DAVID D",150000,236000,86000
R133162,CITY REDEVELOPMENT LLC,"LUETHE-PLATZ,CHRISTINA L",170000,256000,86000
R317639,RMJ PROPERTIES LLC,"ANDERSON,NICOLE",133000,219000,86000
R236697,"PAXSON,PAUL &","BARBER,MICHAEL D",130000,216000,86000
R216561,"SPROULS,CHRISTOPHER R &","CARLTON,LOUIS J",409000,495000,86000
R204838,"LOTATE,SHULAMIT","LAPOMA,RYAN &",150012,236000,85988
R334008,LOVELIN INVESTMENTS LLC,"THOMAS,KEARA &",100000,185950,85950
R170565,JDR PROPERTY INVESTMENTS LLC,"NORTON,ROGER",144000,229900,85900
R279040,BULLDOG CAPITAL PARTNERS LLC,"EIKENBERRY,GARY",169353,255000,85647
R306508,"BUCK,ROD L","SEETHOFF,JOSHUA",140000,225500,85500
R337555,"TALAL,FAINA","MITCHELL,ERIK",134500,220000,85500
R236544,STEADFAST PROPERTIES LLC,"ARMSTRONG,NEAL &",154500,240000,85500
R189580,WCPC LLC,STRATANCE LLC,82650,168000,85350
R171374,"CUNNINGHAM,PATRICK J","SACKETT,LORI B &",549900,635000,85100
R208526,"LE,ROBERT A","MOORE,JAMES",157999,243000,85001
R136467,WILLAMETTE VALLEY,"ALLISON,MOLLY A",235000,320000,85000
R100611,"LEE,DIANNA L &","CRANE,LAWRENCE M &",230000,315000,85000
R291028,ABB LLC,"ESPINOSA,ANTONIO A",162000,247000,85000
R146459,"KELLY,CHARICE M","SMITH,STEVEN E",90000,175000,85000
R488140,"SARKISIAN,ROBERT","AGIC,AMIR &",180000,265000,85000
R117496,"MCGRATH,KENDRA","KOBLACKI,KELLY",105000,190000,85000
R247519,"REYNOLDS,JOANN-50% &","SOUZA,DARRELL D",265000,350000,85000
R258269,RESTORATIONS BY K & C,"OLENSLAGER,DELBERT S &",126000,211000,85000
R283502,"KIRK,MICHAEL R","SWETT,ANNE L",110000,195000,85000
R283415,COHAESUS HOLDINGS GROUP 2 LLC,"BARNETT,FRANCIS R &",250000,335000,85000
R210004,VINTAGE PROPERTIES NW LLC,"MCDOWELL,MARIA G",140000,225000,85000
R116154,"JENNINGS,ELIZABETH A &","JELEN,JONATHAN &",160000,245000,85000
R180135,"MC FARLANE,ANDREW M","DUTCHER,SARAH A",170000,255000,85000
R335920,AMETHYST PROJECT A LLC,"ADKISSON,MATTHEW J &",105000,190000,85000
R213733,ACRA GROUP INC,"TURNER,MARY &",130000,215000,85000
R178629,"PELLEGRINI,TERI L","CRUZ,CHRISTOPHER J",85000,170000,85000
R221956,BLUE HOMES LLC,"KAJITSU,KORI C",215000,300000,85000
R153658,COMPLETE REMODELING LLC,"COX,DONNIE R &",104000,189000,85000
R490141,"GARCIA,JUSTINO","NGUYEN,NGOCTHU T &",90000,175000,85000
R263930,"WIRTA,STANTON","MYRON,DARLA L",175000,259950,84950
R515575,PRODUCTION CREDIT,"ALLEN,BETTY F",105000,189900,84900
R313320,"LE,TU","MURPHY,SAVANNAH K",130000,214900,84900
R131868,"LERMA,JAMIE","SAELIEW,CHAI H &",90199,175000,84801
R212780,"STARK,RICHARD E","ABRAHAM,JOHN T",89250,174000,84750
R151380,"JOHNSON,BILL &","CREEK,DAVID",110500,195000,84500
R254544,"SNELL,JOHN","VAN VEEN,KRISTA A",130510,215000,84490
R233520,BUILDER CHICK LLC,"TINKHAM,JEFFREY M &",345570,430000,84430
R268252,"NEWMAN,ROSALIE K","RYUN,JAMISON &",95600,180000,84400
R338000,"SCOTT,RAY","BLAND,ALAN ET AL",120000,204338,84338
R218236,"NGUYEN,NGOC","MAW,SAW M",60799,145000,84201
R311270,J-2 INVESTMENT INC,"STROHMAYER,PAUL J &",102000,186150,84150
R121519,"FOTEFF,TIM","DEVAULT,CHARLES A",55250,139400,84150
R129858,MODIFI LLC,"MOORE,OCTOBER T",114900,199000,84100
R145877,"HERNANDEZ-LOZA,MIGUEL","RHODERICK,SHAWN C",68000,152100,84100
R156419,WHOLESALE REAL ESTATE LLC,"BERGSTROM,CHARLES N &",165900,250000,84100
R145877,"HERNANDEZ-LOZA,MIGUEL",Sale In Progress,68000,152100,84100
R333157,"MCBEE,THEODORE D &","RAUCH,SPENCER G &",180000,264000,84000
R119748,"BLEDSOE,ROBERT T &","FARIS,CAROLYN M",41177,125000,83823
R115531,BKB INVESTMENTS LLC,"KREBS,DAVID &",119000,202500,83500
R263491,"LIU,DE &","SAVELYEVA,RAISA",91500,175000,83500
R146628,"GRIDER,MARK","SOMERS,JESSICA A",131500,215000,83500
R276396,ENCORE DEVELOPMENT,"STORLIE,MARTIN R",66580,150000,83420
R286862,"JOHANSON,ERICK T &","PELOWSKI,BRIAN D",156500,239900,83400
R216117,"MULHEARN,JAMES &","MONSON,JOSEPH G",186650,270000,83350
R172592,"PISTILLI,AMALIA &","CARSTENSEN,LINDSAY",271750,355000,83250
R108111,"LEONG,PAK","REDMOND,JAMES C &",116333,199500,83167
R269106,"DARLING,KAREN","CROSBY,GAIL",275900,359000,83100
R197218,"LI,LAI MEI","HOWLETT,SIMON J &",80000,163000,83000
R158101,"CREVER,CHRIS","WEBER,JOHN C &",162000,245000,83000
R155787,EWCP TS FUND LLC,"SCHAUFFLER,SUNIL &",252000,335000,83000
R298240,"JONES,DANNY J","COLLI,LAUMER",220000,303000,83000
R172194,"SHANNON,MICHAEL P &","HERRON,PATRICIA J &",165000,247947,82947
R293923,BEAVERTON HOMES LLC,"NISPEROS,BENNY F",87000,169900,82900
R158802,"KELL,RYAN &","AXMAKER,LISA M &",79650,162500,82850
R160096,RED GAP HOLDINGS LLC,"SENKBEIL,RANI",107100,189900,82800
R104539,SILVER POINT PROPERTIES,"CROCKER,DENNIS &",112500,195000,82500
R159702,"GRAALUM,JASON &","FRANSHAM,MARK B &",147500,230000,82500
R217690,"LUP,VASILE","NITU,MARIAN G",103550,186000,82450
R157653,"SEEGER,STEVEN S","LAYTON,SARAH R",227600,310000,82400
R116417,EDEN ENTERPRISES LLC,"POOSCHKE,MARK J",107699,190000,82301
R181499,SOLID GROUND PROPERTIES LLC,"ESHELBY,AMY",99250,181500,82250
R258570,KIMCO PROPERTIES LTD,"MARTINDALE,JIMMY R &",82500,164700,82200
R334736,"ALVAREZ,GILBERTO &","ESCHWEILER,ANN &",77840,159995,82155
R213601,"VOGEL,MICHAEL C &","RODEMAN,PAUL CHAMBERS",167900,250000,82100
R173781,"ROWELL,JAMES &","GRENWIS,SARAH",99950,182000,82050
R496413,"SCHMIDT,HAROLD &","FREE,BRYAN E &",135000,217000,82000
R236059,"KIRK,DIANA","DYETT,TREVOR T &",92000,174000,82000
R217874,HIGHLAND HOLDINGS LLC,"IVANYUK,VOLODYMYR &",137000,219000,82000
R247341,"DAPP,BRIAN","TRUDEAU,ALYSSA",127000,209000,82000
R138483,WILLAMETTE VALLEY PROPERTY,"SJOTHUN,ALLISON L &",385000,467000,82000
R274426,"VU,ROSY T &","SANAMANE,SYPHAHATH H &",285000,367000,82000
R122069,"STARR,BECKY A &","HOBSON,PAUL",193250,274900,81650
R258603,"LAURIC,SAMUEL","HARVEY,TANYA E",91000,172500,81500
R267871,MODERN TRANSFORMATIONS LLC,"TRAMMELL,JEFFREY S &",99500,181000,81500
R289332,"TORCATO,ANTHONY D","WOODS,NICHOLAS J &",146500,228000,81500
R137646,"EIPPER,FRANCOISE R &","FROST,ROBERT CHRISTOPHER &",295950,377000,81050
R645409,"PEITZSCH,PAUL &","ESPENEL,ROBERT W JR &",579900,660900,81000
R241641,"JOHNSON,BILL &","BARTON,MATTHEW C &",149000,230000,81000
R114219,"GRONER,JERALD N &","MOSER,MELISSA K &",225000,306000,81000
R153918,GADZOOKS! INC,"STROHMER,CARLA R A",84000,165000,81000
R122898,"DYSON,ALLAN &","FAULHABER,THOMAS L &",575000,656000,81000
R251490,"BRAEM,RICHARD","ORTIZ,JONATHAN &",141000,222000,81000
R171517,"LOCHNER,ERIC R","SAMUELS,ERIC H &",864000,945000,81000
R164078,"ROMANOV,DANIIL","CHEEKS,HAROLD B JR",115000,196000,81000
R229380,"RYDER,JOHN","REOPELLE,TERRY L",55000,135900,80900
R174612,SE CONSTRUCTION LLC,"WHITNEY,NICOA &",84300,165000,80700
R235567,J2S PROPERTIES LLC,"FOSTER,MAX D &",150000,230500,80500
R212201,REFORMA LLC,"HURN,CAROL L &",82500,163000,80500
R236153,RESTORATIONS BY K & C SAVINGS &,"FREED,JASON",101000,181500,80500
R245329,"COVERT,BARBARA &","TURNER,CARL E",70000,150362,80362
R245691,TRUE BREAD PROPERTIES LLC,"BORING,MELISSA A",67700,148000,80300
R273195,"DENTON,JAMES C &","WEBB,LONNY R &",324950,405000,80050
R254528,BGG INVESTMENTS LLC,"GHEBREIGZIABHER,TSEGAI A &",120000,200000,80000
R245433,RED GAP HOLDINGS LLC,"HUBBARD,GARRETT L",109000,189000,80000
R155855,"GRIDER,MARK","MADER,CHRISTOPHER",190000,270000,80000
R335774,"JONES,DANNY J",IR-VAN CONSULTING GROUP LLC,215000,295000,80000
R174720,"LE,ROBERT A","MACDONALD,ANNE M &",115000,195000,80000
R260214,EWCP TS FUND LLC,"MELASECCA,MICHELE A",350000,430000,80000
R117040,"KERESZTURI,TIBOR","LAVIOLETTE,LINDA",215000,295000,80000
R113037,"RUTHERFORD,JAMES Q","LUJAN-BEAR,FELIPE N &",489000,569000,80000
R503983,"ALTON,JEFFREY L","SHELDON,RYAN",155000,235000,80000
R148909,"KIP,RICHARD M","EVANS,TRISTAN M",150000,230000,80000
R301813,HARTLEY INVESTMENTS LLC,"STRAW,MANDY S",240000,320000,80000
R217051,TERRAPIN PROPERTIES LLC,"BARISICH,ALLISON",85000,165000,80000
R278667,"IVES,BONNIE","GRIFFITH,KENNETH D &",110000,190000,80000
R167797,HERMES BROS LLC,"D'ANGELO,GIAN-MARCO",188500,268450,79950
R336410,OREGON VIEW 850 LLC,"KLEEN,NATHAN T",95000,174900,79900
R294835,"NEHRING,CURTIS &","GUINEY,STEVEN D &",250000,329900,79900
R284438,"LOOPSTRA,BRENT &","ALLRED,DAVID S",256200,336000,79800
R313203,"RUSHTON,LONNY &","PORTER,KENNETH M &",309200,389000,79800
R327018,"WELCH,MIKE-50% &","LEHMANN,PETER B &",397500,477100,79600
R144257,"JONES,MICHAEL","COOPER,CHRISTINA ANN T &",58500,138000,79500
R103829,"PIPGRAS,MARTIN J","PELTOMAA,MICHAEL &",130500,209950,79450
R224735,"HELLEBRAND,JANA","JACKSON,JARROD",143000,222000,79000
R251921,"LE,ROBERT A","DAFFERN,MATTHEW D &",105000,184000,79000
R554228,BLACK DIAMOND CAPITAL LLC,"GUTWIG,JON C &",450000,529000,79000
R292786,"SHEDRICK,CAROL","COX,LYDIA Z &",98000,177000,79000
R137019,STAI CONSTRUCTION LLC,"CLASSEN,KRISTIN M &",86000,165000,79000
R197050,TTM CAPITAL FUNDING LLC,"PARKER,TREVOR A &",129000,208000,79000
R146210,"CHEN,XIN XI &","YELTON,GRACE &",186000,265000,79000
R253882,"BOURGO,PAT","BUSCH,DARILYN",160000,239000,79000
R225552,"VAYNER,ARKADIY","CHO,DANIEL Y",136000,215000,79000
R143460,"LIN,HEYOU &","FOORD,SHANNON M",140000,219000,79000
R144220,RED GAP HOLDINGS LLC,"WASCHOW,JULIA M",100940,179900,78960
R181321,EDEN ENTERPRISES LLC,"GAFFNEY,THOMAS W &",120000,198900,78900
R242210,ANDERSON SHULER AQUISITIONS,"MCVICAR,MATTHEW",116000,194900,78900
R317537,"CHAN,HELEN","WHITTEN,SALLY JO",106500,185000,78500
R182044,TRELSTAD CONSTRUCTION LLC,"MICHAAN,ANDREW",350000,428405,78405
R133442,"FRITZ,THOMAS","WUETHRICH,CHRIS &",182000,260000,78000
R282244,PORTLAND DEVELOPMENT GROUP,"DARLING,KAREN",200000,278000,78000
R216210,GORILLA CAPITAL CL 6 LLC,"HARRAH,APRIL &",160000,238000,78000
R194580,WOLF CAPITAL LLC,"ARTHURS,CAROLE D",87000,165000,78000
R151710,"MCBEAIN,KELLY J","WILLIAMS,ALLISON M &",100000,177900,77900
R214293,"THOMPSON,MARVIN &","WINDHAM,PATRICIA",147100,225000,77900
R281592,BRQ PROPERTIES LLC,"RANDALL,LARRY &",97125,174700,77575
R217166,TRUE BREAD PROPERTIES LLC,"KNUTSON,CRAIG &",77500,154950,77450
R310970,"KUHN,KRISTIAN","KORMAN,TRAVIS",80106,157500,77394
R270152,"BURKHOLDER,LEON S","SEABORNE,SARAH",106410,183600,77190
R143488,"PONTHIEUX,NOEL A &","REA,REGAN",325000,402000,77000
R546703,HR STARK PROPERTIES LLC,"NELSON,WILLIAM E &",183000,260000,77000
R172650,STEINER REMODEL LLC,"SHRIKI,RINA M &",175000,252000,77000
R296129,ACCENT ON DESIGN INVESTMENTS INC,"FOREMAN,STACEY L &",258000,335000,77000
R333277,CASTALDO CONSTRUCTION,"BROWNING,JENNIFER L",120000,197000,77000
R310550,"DAVIS,SAMUEL R &","WEAVER,RUTH A TR &",147500,224500,77000
R248953,KLOH LLC,"LEAHY,SCOTT &",80000,157000,77000
R264029,WILLAMETTE VALLEY,"GORDON,IAN C &",155500,232200,76700
R258295,"LESLIE,JOHN A","CARTER,KENNETH R SR",163000,239500,76500
R242127,PORTAL PROPERTIES LLC,"AILES,JOSH &",177500,254000,76500
R225830,DEL REY PROPERTIES LLC,"VERBLE,BENJAMIN P &",90000,166500,76500
R200731,"BOURS,HEIDI","GILBERT,ERIN &",448500,525000,76500
R277103,"HENDRICKSON,DARLENE &","STEVENSON,LARRY S",178500,254900,76400
R197649,"LI,HONGBO-50% &","PUC,EITEL A P",99000,175000,76000
R120865,LIFE QUEST LLC,"BECKER,ELIZABETH L",63900,139900,76000
R132311,"PICKETT,MICHAEL T &","WALKER,BETH-ANN P &",126000,202000,76000
R253891,"BOCK,JAMES","CONROY,JODON P &",73000,149000,76000
R193937,RARO LLC,"ABRAHAM,PHILIP T SR &",115000,191000,76000
R261712,"FITZGERALD,KENNETH","DUCKWORTH,SALLY",87000,163000,76000
R329116,"BUTLER,ZANDY","NGUYEN,TUONG &",260000,336000,76000
R332402,KLOH LLC,"SWINEHART,ERIC W &",102000,178000,76000
R229605,"FISCHER,LYNDON M","BROWN,VERNON L",119000,194500,75500
R261826,"LAURIC,SAMUEL","EDER,JOHN P",94500,170000,75500
R252929,"WALSH,BOB &","GARDNER,LYNNEA N",136000,211500,75500
R112113,GOOD FAMILY REAL ESTATE LLC,"CROWLEY,CHRISTAL M",73100,148500,75400
R249766,"NEEF,BRAD","YANG,JEPH &",153720,228995,75275
R228967,"ADAMS,DENNIS B","JHAVERI,KAVITA S",80000,155200,75200
R309453,"DENNIS,SETH","ALBANO,RONALD &",309900,385000,75100
R181163,"COLYVAS-WEST,ADRIANNA &","HALL,JESSICA",120000,195000,75000
R292899,"SHERVEY,FREDERICK G","O'LOUGHLIN,KELLY A",155000,230000,75000
R337744,GOOD FAMILY REAL ESTATE LLC,"MCCRORY,DENNIS L &",70000,145000,75000
R490906,"DISCIASCIO,KAREN E &","NORTHUP,JOHN W &",150000,225000,75000
R137508,DDH INVESTMENT PROPERTIES LLC,"BEAN,KELLY &",260000,335000,75000
R156387,BKB INVESTMENTS LLC,"MULLER,REID &",105000,180000,75000
R224232,BLUE HOMES LLC,"DUGAN,DANIEL C &",145000,220000,75000
R122345,"HOLLAND,THOMAS C &","RAE,DEBORAH L",255000,330000,75000
R137333,TTM CAPITAL FUNDING LLC,"BUCK,DAVID H",130000,205000,75000
R263849,"MCBRIDE,LARRY &","KAUFER,ELLEN",125000,200000,75000
R268648,TEAM CAPITAL & INVESTMENT,"CARLSON,ERIK",155000,230000,75000
R154859,"BROWN,DENNIS L &","LUNCEFORD,JEFFREY A &",240000,315000,75000
R109280,"CLOW,BRUCE","BADER,STEPHEN B",625000,700000,75000
R250441,"LOHMEIER,HENRY J","LOHMEIER,BRANDON",155000,230000,75000
R286828,MJK CONSTRUCTION LLC,"BORTH,NATHANIEL &",145000,220000,75000
R577037,"LE,ROBERT A","DELAPAZ,KRISTINE L &",65000,140000,75000
R258710,"GARCIA,BENITO","HERNANDEZ-RODRIGUEZ,EDGAR",125000,200000,75000
R118319,RIDGEWAY PROPERTIES LLC,"POOL,NATHAN C",71000,146000,75000
R104293,69HOME LLC,"DUTCHUK,RYAN M",75000,149950,74950
R225096,"JACOBSON,ROY","KNOBBS,MITCHELL R &",175000,249900,74900
R221347,AAV ONE LLC,"GOODKNIGHT,CHRISTEN L",65000,139900,74900
R312011,"PALMERSTON,CAROL J","FULLER,PATRICK J",105000,179500,74500
R222171,"BRAY,NIGEL T","MACUIBA,ANDREW M &",217750,292000,74250
R319722,"BERNHARDT,NATHAN","CLEMENS,CARLIE",125900,200000,74100
R121587,"TAYLOR,JOHN","OZMER,LINDSEY A",87900,162000,74100
R156560,"BERK,CAROLYN H","LEWIS,ADAM M &",401000,475000,74000
R110316,32 RED LLC,"TINKER,JIMMY R &",118000,192000,74000
R111600,"O'NEIL,CHARLES R &","O'NEIL,EUGENE C",106000,180000,74000
R235453,TTM CAPITAL FUNDING,"LAYMON,CHERYL P",128000,202000,74000
R241954,TTM CAPITAL FUNDING LLC,"JOHNSON,JAMIE M &",134000,208000,74000
R241991,"CRAFT,KENNETH","GRIFFITHS,ERIC",89000,163000,74000
R194999,"COHEN,ADAM J","SIMPSON,JEFFREY R &",190000,263900,73900
R159648,PAPERBOY PROPERTIES LLC,"EATON,JOHN &",46000,119900,73900
R321165,"MAGER,ROBERT W","THRASH,CYNTHIA L",131250,205000,73750
R133053,"GOOD,HERBERT A","REDDISH,GEORGE A &",86401,160000,73599
R252304,"GANNON,OWEN R &","HALE,BRYAN &",126320,199900,73580
R152025,"EISELE,HUGH","HARDMAN,THOMAS",108500,182000,73500
R241864,"DAPP,BRIAN","KIRSHER,ROBERT W &",121000,194500,73500
R218422,"CAMPBELL,MARVIN M TR","HARMON,JENNIFER C &",136500,210000,73500
R207812,"YOUNG,ROBERT L","CURRY,ROBERT J &",86500,160000,73500
R486896,"ENSIGN,AARON","ELLIS,SHAWN E",76000,149500,73500
R338643,"DO,MICHAEL T &","LOPEZ,KYLE &",84600,158000,73400
R294037,PIERCE INVESTMENTS PROPERTIES,"CONTRERAS-CARDONA,JOSE T",172500,245900,73400
R217086,TERRAPIN PROPERTIES LLC,"LEWIS,TIMOTHY",71000,144000,73000
R279486,"ROGELSTAD,DOUGLAS &","GRASSL,ELEANORE M",115000,188000,73000
R283635,"ENSIGN,HOLLY","RAMIREZ,LUIS ALBERTO R &",109000,182000,73000
R112321,"LI,HONGBO","KELLEY,WENDY J &",120000,193000,73000
R236658,"BROWN,DENNIS &","FERNANDEZ,AL M &",103000,176000,73000
R146694,"LE,VI TUONG &","FERNANDEZ-SALVADOR,JAVIER A &",125000,198000,73000
R146694,"LE,VI TUONG &",Sale In Progress,125000,198000,73000
R125766,WCPC LLC,"YUSUPOV,SAL-50% &",65000,138000,73000
R282440,"FOTEFF,PAT T &","RONDEMA,RUTH J",125000,197900,72900
R217123,"LOONG,PAK","SALAZAR,MARIO A",90000,162695,72695
R280226,"ALBRIGHT,ALLAN H","FAWN,KELLY",140000,212600,72600
R338709,"GIBSON,STEVE",PNW CONSTRUCTION INC,107000,179500,72500
R127578,CHRISTENSEN 401K PLAN TRUST,"SHUMAN,KELLY",95000,167500,72500
R148493,"SPARKS,ROBERT A JR","CAO,RAYMOND HOANG VAN",119500,192000,72500
R223327,"STOICA,DANIEL","KENNEDY,SHAUNA",147644,220000,72356
R272682,WILLAMETTE VALLEY,"MYERS,PAULLA",117576,189900,72324
R161957,"LE,ROBERT","DEKEBO,GENET N",96599,168900,72301
R188588,"CARMICHAEL,DAVID &","BRADLEY,ANNE F &",667950,740000,72050
R222483,"BORSAY,STEPHEN","EGAN,BERNARD",130000,202000,72000
R288465,"ZANCA,PAULETTE Y &","WILSON,JAY",490000,562000,72000
R153638,"NGO,TRUONG &","DIKEMAN,MARK",74000,146000,72000
R190521,"HOGAN,RICH &","CONNOR,ERIN R",265000,337000,72000
R133407,"GILSDORF,JEFFREY L","ANDERSEN,KECIA L",263000,335000,72000
R144981,"ENSIGN,HOLLY","HEFFLINGER,ANNIE M &",115000,187000,72000
R338120,"CHAN,FUK WING","GENDRON,AIMEE R &",108000,180000,72000
R116486,"GIBSON,STEVE","LINCOLN,THOMAS K",143500,215000,71500
R239096,"CASHATT,KEVIN","CHISUM,STEPHANIE M",83500,155000,71500
R103640,"SATH,SAVETH &","CHANOCUA,RODRIGO &",108500,179900,71400
R119741,100 ACRE PROPERTY LLC,"JOHNSON,LASHAWNDA M &",85000,156305,71305
R158851,"ZARATE,GERARDO M","HULBERT,COURTNEY &",124000,195000,71000
R161938,MALCOM INVESTMENTS LLC,"ESTEVEZ,JENNIFER W",102000,173000,71000
R130714,KEYSTONE RENOVATIONS LLC,"HANSEN,APRIL M &",307000,378000,71000
R170402,KLAMS I LIMITED PARTNERSHIP,"WIENER,CHAD E &",154000,225000,71000
R334675,"NAM,SOPHEAR-50% &","KAUFFMAN,MICHAEL K JR",89000,159999,70999
R321656,"GOOD,HERBERT","PAYTON,GARY",76000,146900,70900
R164385,CALIBRATED INVESTMENTS LLC,"CLARK,MYRON D &",125000,195900,70900
R309107,GORILLA CAPITAL CL 2 LLC,"POINDEXTER,ARIANNE",144250,215000,70750
R233071,ALPHA BUILDING VENTURES,"PEDERSON,JEFFERY A &",110395,180900,70505
R298144,"FRY,BONNIE J","HART,ADAM H &",125000,195447,70447
R110431,"SAIFER,STEFFEN L &","VANYI,RODNEY T &",131716,202000,70284
R297471,JGB HOMES LLC,"ROSENBAUM,SAMUEL",214900,285000,70100
R636927,"HILL,JACOB L","BOYD,DAVID R &",269900,340000,70100
R610947,"DISCIASCIO,BARBARA","TRAVERSIE,JOAN",114900,185000,70100
R215277,"MCGONIGAL,MICHAEL J","MILLS,COLE L",204900,275000,70100
R222463,LAKIN+HANSEN LLC,"LEINEWEBER,JOSEPH P &",244900,315000,70100
R162306,"MC GINLEY,MICHAEL E &","NALBACH,JAY A &",730000,800000,70000
R151304,"BERNHARDT,NATHAN","GREEN,ROBERT J",110000,180000,70000
R337881,"CHAN,YUE KOK &","MEISNER,ALEX &",115000,185000,70000
R245488,JET INVESTMENTS LLC,"ZERFAS,JOHN D &",220000,290000,70000
R227271,DILUSSO HOMES LLC,"LEMASTER,JONQUIL",115000,185000,70000
R309952,"KIRK,DIANA &","KIM,TOMMY L",102000,172000,70000
R153851,BURTON AKERS LLC,"SHAW,DEREK M &",185000,255000,70000
R218299,"LI,HONGBO &","NEILL-JONES,DAMIEN",96000,166000,70000
R121447,"GALBICK,GARY","HEYE,PAUL B &",410000,480000,70000
R214021,"SARGENT,GARY W","HARROUN,JEFFREY A",105000,175000,70000
R115447,"NEDELISKY,MICHAEL","MAKI,JOANNE",120000,190000,70000
R146234,"ENSIGN,AARON","SMILEY,MATTHEW M &",80000,150000,70000
R234682,"GOMEZ,ITANDEHUI","TSEGAYE,YOSEF M &",160000,229950,69950
R108959,"BUTLER,JEFF","LOOMIS,JENNIFER",105000,174950,69950
R120221,"TAYLOR,MARK","SULLIVAN,APRIL M",65000,134900,69900
R180072,JET INVESTMENTS LLC,"MOUNTSIER-COLE,CYNTHIA",170000,239900,69900
R205310,"CHAN,SAM FUK WING &","O'DONNELL,JOHN C",170625,240500,69875
R313111,"COLLIGAN,JOHN A &","CLEARY,KEELAN &",230200,300000,69800
R314001,"CULP,KATHY &","FROST,ANGELA M",110250,180000,69750
R234773,TRINITY SERVANTS LLC,"SIMMONS,FOREST W &",100500,170000,69500
R290108,KLOH LLC,"SINE,BLAKE",100000,169500,69500
R274889,"LENGELE,MARK H","GRICE,ALLISON M",246850,316000,69150
R336436,ROYAL RENTALS LLC,"GRUBBS,DEE ELLEN TR",71000,140000,69000
R109662,"HUYNH,HICHI","CHAN,CALVIN",107000,176000,69000
R336436,ROYAL RENTALS LLC,THE LANDON JOHNSON FAMILY,71000,140000,69000
R211679,"HOPPE,JOE","CORNELIUS,LEE A",185000,254000,69000
R113175,RUNNING WATERS PROPERTIES,"HETTLE,KURT &",430000,499000,69000
R244773,ALPHA BUILDING VENTURES LLC,"HUSKINS,GINA",106000,175000,69000
R272275,"BISACCIO,GARY &","MCISAAC,JOHN A &",325000,394000,69000
R297038,"KEMP,CHRIS","MARTINI,STACY R &",160000,229000,69000
R221011,"KAHN,BRIAN &","KAPLAN,JESSICA &",216100,285000,68900
R291457,"LEONG,PAK MAN","CARD-VINSON,NICOLE &",71000,139725,68725
R307399,"WILL,CRAIG-50% &","CHRISTENSEN,MARIAN E",238500,307000,68500
R232151,"WOLFF,DANIEL W &","SCHAFER,SARAH P",261500,330000,68500
R197158,"LEONG,PAK","O'FLYNN,TARYN &",105000,173500,68500
R236255,RESTORATION BY K & C SAVINGS &,"BOWEN,SUSAN A",125800,194250,68450
R292305,ROSCO INC,"LYMBERIS,PETE G &",210000,278418,68418
R540711,"DING,XIANG JI &",D S & S 1278 LLC,89250,157547,68297
R281640,EQUITY TRUST CO CSTDN,"HEICK,JOHN P",109000,177000,68000
R303272,"RYDER,JOHN","STUART,TOM E &",92000,160000,68000
R202527,"CLEGG,STACEY","SEARCY,BRIAN &",517000,585000,68000
R239952,"EMMERT,TERRY W","COLASANTI,ANDREW J",90000,158000,68000
R215086,"LE,BE XUAN &","LEE,KWOK P &",122000,190000,68000
R160033,"VAN DEUSEN,ANNA E","YOUNG,MICHAEL &",207200,275000,67800
R311708,"WILLIAMS,ALAN","LASCHKEWITSCH,KELLY &",262321,330000,67679
R319854,"CREVER,CHRIS","JOHNSON,RALPH E",126000,193600,67600
R133421,"ARECHIGA,MATTHEW E",PIERCE INVESTMENTS LLC,175000,242500,67500
R114968,"WARREN,MARGARET P","CLIFT,ANDREW &",362500,430000,67500
R144998,STOTT CIRCLE LLC,"BRITTON,NETTAJANE &",81500,149000,67500
R120384,TTM CAPITAL FUNDING LLC,"BOARDMAN,BRIAN M &",130000,197500,67500
R270153,WOLF CAPITAL LLC,"JONES,GERALD D &",67500,134999,67499
R290632,TRINITY SERVANTS LLC,"RICE,TASIA M &",97000,164125,67125
R621419,JGT INVESTMENTS INC,"MATHIS,JONATHAN B &",159000,226000,67000
R289033,GREENWING RESTORATIONS LLC,"LACATUS,ION",135000,202000,67000
R107730,"COVERT,JENNIFER &","STALKFLEET,MARY A",155000,222000,67000
R263646,JACAL LLC &,"OCHOA,LUIS S",80000,147000,67000
R139111,C & M DEBT RESOLUTIONS LLC,"GREENE,ROBERT F",90000,157000,67000
R268675,"BAUER,BARBARA","O'SHAUGHNESSY,PETER J",159000,226000,67000
R216909,"LEONG,PAK &","BRAVO,ERNESTO R",103000,170000,67000
R133247,"GOOD,HERBERT","ORCUTT,KELSEY E",82900,149900,67000
R306866,"WILLIAMS,DARCELLE J","PETERSON,KEN &",241450,308430,66980
R102382,"ALEXANDER,SHARA &","RAGSDALE,KELLY J II &",247000,313900,66900
R157589,"MCCLUER,SCOTT E","GEORGE,KATHY J",102000,168900,66900
R119426,"ADAMS,DENNIS","MELODINI,AMANDA",103400,170000,66600
R165972,AAV ONE LLC,"PICCOLO,JERRETT B",72000,138500,66500
R165972,AAV ONE LLC,"PICCOLO,JERRETT B",72000,138500,66500
R332166,"ROMANOV,DANIIL","HOFF,COOPER",57500,124000,66500
R261588,"SCORTE,DANNY","BAYLEY,GARLAND J &",141000,207500,66500
R283104,"HOYT,DANIEL","WAGNER,JEROME &",248500,315000,66500
R167255,SIGNATURE CHOICE HOMES LLC,"ROBINET,ALYSSA",130000,196500,66500
R107300,GIBSON HOMES INC,"GOODMAN,ERYN &",118550,185000,66450
R516904,"CHAN,FUK WING","KASALI,OLADELE O &",123250,189500,66250
R135417,"LEONG,PAK M","MORRIS,KATRINA",68900,135000,66100
R258544,VINTAGE PROPERTIES NW LLC,"BANKS,EMILY A",63000,129100,66100
R104470,GADZOOKS! INC,"YOCUM,PAULA A",105000,171000,66000
R230178,"STRECH,GREGG E &","ROSS,WILLIAM B &",220000,286000,66000
R252036,"CHAN,HELEN FONG","HILLIARD,KRYSTLE &",135000,201000,66000
R137578,CAPO INVESTMENTS INC,"SMITH,PATRICIA A",96000,162000,66000
R140123,"PLATT,ROBERT","SLACK,BERNARD J &",164000,230000,66000
R240324,"MAURER,PETER","TIMM,ERICA J",65000,131000,66000
R235170,"ROMANOV,GENNADIY","WARD,STACIE A",44000,110000,66000
R180195,RED SQUARE DEVELOPMENT LLC,"RASTLER,PAUL &",189000,255000,66000
R296327,"BURNETT,CURTIS","FISER,GERALD C",99000,165000,66000
R498238,SURAN INVESTMENTS LLC,"SOMAIL,WAJEH &",75099,141000,65901
R329991,"POPE,MATTHEW L","O'GLASSER,AVITAL Y &",214000,279900,65900
R489352,ALL COMFORT INSULATION,"KOROBEINIKOV,ALEXIS I",153000,218750,65750
R159082,TRUE BREAD PROPERTIES INC,"BUTCHEK,JESSIE L",84346,149950,65604
R205314,"SHERMAN,MATTHEW N","MARONEY,OLIVER",156500,222000,65500
R172082,JACAL LLC &,"GREENHAW,KATHLEEN M",100500,166000,65500
R129928,"SHERRILL,KIRK","ORR,DANA V &",139284,204700,65416
R186599,"HIBBEN,BRANDY","STRAHL,CHRISTOPHER J &",344750,410000,65250
R337931,"KASRMELI,MECHLIN &","NGUYEN,HIENMINH THANH",87000,152200,65200
R158822,"YANG,LIMEI","TAFOLLA,JESUS B",93900,159000,65100
R108896,GOOD FAMILY REAL ESTATE LLC,"HELM,JOANNA R ET AL",64800,129900,65100
R252845,"KRAVETS,MIKHAIL","TSVYETKOV,ARTEM &",150000,215000,65000
R220298,"NUNEZ,FERNANDO &","NUNEZ,DIANA D",170000,235000,65000
R503361,STOTT CIRCLE LLC,"KELTY,WILLIAM",70000,135000,65000
R190554,"GEFFEN,MALKA &","WOODS,JENI L &",374900,439900,65000
R295315,"STEPHENS,TERI L","CHURCH,CHARLES W &",305000,370000,65000
R120954,"MONTANI,MARTHA","COLE,LISA A",115000,180000,65000
R244296,"NASH,SCOTT","SAMSON,NANCY",110000,175000,65000
R298232,"BUTLER,JEFF","MORGAN,SHAUN W &",110000,175000,65000
R297692,AAV ONE LLC,"GADDINI,MEGAN",168000,233000,65000
R621419,JGT INVESTMENTS INC,"NGUYEN,TRAN V &",159000,224000,65000
R621419,JGT INVESTMENTS INC,Sale In Progress,159000,224000,65000
R107088,EWCP TS FUND LLC,LMP ACQUISITION II LLC,350000,415000,65000
R337691,"SNOOZY,MIKE &","HIRTLER,ELIZABETH",70000,135000,65000
R151472,KOKER INC,"GRAVES,MARY C",140000,205000,65000
R192222,TRUE BREAD PROPERTIES LLC,"SULJIC,NERMIN",100000,164950,64950
R170828,JAMES ROYCE INVESTMENTS LLC,"NEWMAN,ROY F JR &",176583,241500,64917
R228556,"WATERHOUSE,JON","LELI,NICHOLAS &",475000,539900,64900
R216991,"HAMBERG,LEON G","SOLHEIM,DAVID",85101,149950,64849
R280115,"SLAC,GARY &","MEYER,GREG JR &",80000,144700,64700
R118336,BTR PROPERTIES LLC,"CASLEY,JOSEPH",115300,179900,64600
R195756,"IANNOTTI,PAUL M","COLGROVE,JOHN P",212000,276500,64500
R115346,"MOSTAFAVI,NAHID","ALISKI,VALERIE",250000,314425,64425
R313541,K BREDENKAMP PROPERTIES LLC,"HORROCKS,JULIE S D",89100,153500,64400
R230716,WILLAMETTE VALLEY,"CARHART,JOHN L",210995,275000,64005
R120211,"MATTHEWS,ROB","WROBLEWSKI,JENNIFER A",105500,169500,64000
R167971,BKB INVESTMENTS LLC,"PINNIGER,STEFANIE R &",85000,149000,64000
R321582,"CHAN,FUK WING","TROSPER,BENJAMIN &",90000,154000,64000
R144715,"NEDELISKY,MICHAEL","HALL,JACOB",115000,179000,64000
R136455,FAST CASH HOUSE BUYERS LLC,"CARDMAN-PEDEN,RACHEL &",205000,269000,64000
R283270,"KAZAKOV,SERGEY &","OSTRANDER,MARIAH K",60000,124000,64000
R120063,BUCKSTAR INVESTMENTS LLC,"GENTRY,CHRISTOPHER",110000,173900,63900
R182693,"DAPP,BRIAN","PROMPRASERT,SIRILAK",174000,237700,63700
R148325,KLOH LLC,"KRAMER,WENDY G &",100500,164000,63500
R119284,"KILYUKH,VLADIMIR","ACOSTA,MARTIN P",93500,157000,63500
R213515,CASTALDO CONSTRUCTION,"MURPHY,ELI S",125000,188500,63500
R217026,"LEONG,PAK","JONES,TIMOTHY R",135000,198500,63500
R517055,"WAGNER,KERNAN TR","CO,THINH VAN",109021,172500,63479
R231001,"MORRELL,MONICA M TR","CADUNGUG,MARK &",201500,264825,63325
R247182,"DAPP,BRIAN","VANDERVOORT,SARAH M &",249800,312900,63100
R234736,"GOOD,HERBERT A","KIEPER,TIMOTHY A &",87100,150048,62948
R224748,DIVERSIFIED INVESTMENT,"GOULD,ROLF &",165000,227900,62900
R110297,"RADKE,BONITA S","HENRY,BRANDON J &",199000,261900,62900
R293270,"EISELE,HUGH","HOLLAND,RONALD D",116250,179000,62750
R121740,TRINITY SERVANTS LLC,"VAN DAMME,JESSICA R",83250,146000,62750
R233146,BKB INVESTMENTS LLC,"KOTAR,JASON",107400,170000,62600
R161610,"GAERTNER,DONA S &","MOREY,DAVID J &",225500,288000,62500
R191340,EDEN ENTERPRISES LLC,"LORENZO,JAIME L",170000,232500,62500
R600359,"NASH,SCOTT F","KOEHLER,ROBERT W &",115000,177500,62500
R136741,"LEONG,PAK","CONVIRS,PATRICIA",135000,197500,62500
R121559,"BURTON,TIM","JAGER,MARTIN &",161500,224000,62500
R313780,"MARCHETTA,JONATHAN W","ANDERSON,RENN K &",337500,399900,62400
R144190,"FARIS,CAROLYN M","LAVADORES,EDGAR D B &",119000,181400,62400
R136371,"CHAN,HELEN F","SKROCH,SARAH L &",81000,143170,62170
R137211,JBST LLC,"BRANDT,CHRIS W L &",220000,282000,62000
R494453,"MARANDYUK,ANATOLIY &","HOLMAN,SHARON L",177000,239000,62000
R194602,"VANDERMOSTEN,JOHN G &","WILSON,DARIN &",128000,190000,62000
R168400,"CHALPOUTIS,HARRY","BRODIGAN,DEE E",170000,231900,61900
R205074,"HAMBERG,LEON G","FOULSTON,JOHN &",234200,296000,61800
R265077,LEADER SHIP ENTERPRISES LLC,"LEE,CHRISTINE S",151000,212500,61500
R311255,DREAM HOME RENOVATIONS LLC,"SMITH,LEAH J",118500,180000,61500
R243882,"LOWRY,STACEY","MURPHY,KATIE A",210500,272000,61500
R332165,"BACHARACH,ROBERT L","NOBLEZA,JOSEPH &",83500,144900,61400
R175774,N BUCHANAN LLC,"COLLING,QUINN P",108500,169900,61400
R337785,TRUE BREAD PROPERTIES,"TRUE,JOEL E &",68651,129950,61299
R155139,"PRIMEAU,JOHN &","DAHLMAN,DONALD J &",137850,199000,61150
R159140,CASTALDO CONSTRUCTION,"CARRIKER,CHRIS &",84900,146000,61100
R121749,TRUE BREAD PROPERTIES INC,"ADKINS,VIRGIL P SR &",77000,138000,61000
R177686,"HEINDEL,STEPHANIE","BETHELL,SARA T &",399000,460000,61000
R117353,"THOMPSON,JEFFREY W TR","NADERI-NEJAD,PASCHA &",676000,737000,61000
R199379,"LEONG,PAK &","LEAL,RENE R &",112500,173500,61000
R205350,WILLAMETTE VALLEY,"SCOTTY,MARY M E",165000,226000,61000
R530543,"BRATKOV,VITALY &","CHEN,MING HUAN",145000,206000,61000
R619564,"HYDE,CRAIG S","DICKINSON,JOSEPH H &",244000,305000,61000
R136288,"KING,GARY","LANNING,JOE B",158000,219000,61000
R121587,FOX CAPITAL CORP,FERGUSON GROUP LLC,59000,120000,61000
R244683,"HALLIBURTON,DONALD","HECKATHORNE,REBEKAH",160000,221000,61000
R342399,"LEBEDEV,ANDREY A","DAVYDENKO,ANDRIY Y &",163000,224000,61000
R573652,"MCKELLAR,DAVE","BROGREN,DEWEY &",189000,250000,61000
R333907,"LI,HONGBO","VAUGHN,SHERRY",81000,142000,61000
R336390,GOLDEN OX MANAGEMENT LLC,"TRIPP,MARCIA",97125,158000,60875
R196398,"DOUD,KENNETH R &","PHILLIPS,PAGE A",277500,338000,60500
R242021,"SONSHEIN,MICHAEL","ASHJIAN,MATTHEW",94000,154400,60400
R108086,"ELLAM,INGER &","THORP,JEROME &",76990,137000,60010
R203915,"WAMPLER,SAM","CLEMEN,TIMOTHY J &",304000,364000,60000
R195229,"NASH,SCOTT F","WILSON,GREGORY A JR &",110000,170000,60000
R199573,"HAGARDORN,KURT W &","GUNGOR,YAMAC &",515000,575000,60000
R225256,ABBEY ENTERPRISES LLC,"KREPS,MONTE &",200000,260000,60000
R127775,"WINTER,JEFFREY M &","KOVACH,DIANE",172500,232500,60000
R496249,"CLAYTON,SCOTT","GOODWIN,DEBORAH",90000,150000,60000
R194685,"MAXWELL,DAVID","MENGIS,GREG",100000,160000,60000
R110130,"MEDAK,EDWARD T &","HOAG,CHRISTINE E",145000,205000,60000
R281309,"PRESTON,JOYCE M","EPSTEIN,REED",350000,410000,60000
R610469,"GASSNER,RICHARD E","SHAFFER,ANDREW J",61500,121500,60000
R203466,"DEMING,WILLIAM A III &",STUMPTOWN EQUITY SOLUTIONS LLC,300000,360000,60000
R274805,K BREDENKAMP PROPERTIES LLC,"DUNN,NICHOLAS &",135000,195000,60000
R241378,"COLER,TRUDY T","CULLIGAN,MAUREEN T",188000,248000,60000
R168381,"EDMARK,STEPHANIE","UNGARWULFF,JENNIFER &",118500,178500,60000
R114781,"SINGER,NAOMI P &","O'LEARY,SHANNON T &",270000,329900,59900
R254218,"JACOBSON,ROY","CURTTRIGHT,ANNA D &",190000,249900,59900
R227596,RP & ASSOCIATES LLC,"WEISS,LESLEY I &",230000,289900,59900
R270120,"NEDELISKY,MICHAEL","NEDELISKY,DANNY L &",65000,124800,59800
R212009,URBAN HOMEMAKERS LLC,"DECKER,PAUL W &",315250,375000,59750
R234948,"LEE,GEORGE S","SPRAGUE,BRIAN A &",105000,164600,59600
R183591,DYNASTY CONSTRUCTION INC,"ESPIRITU,MIGUEL A",114900,174500,59600
R312241,"LI,HONGBO","DUNBRACK,JANICE E",98000,157500,59500
R539997,"HAMILTON,DONALD &","REILLY,RONALD R &",129500,189000,59500
R271210,"CHAN,FUK WING","HORN,DAVID J",110075,169500,59425
R339238,"KELLY,CHARICE M","LEON,JUAN R",122000,181400,59400
R248781,"BUSTAMANTE,EDWARD &","BUSTAMANTE,PAUL",166000,225000,59000
R244078,"MILLS,ANTHONY J","HAKANSON,GEOFFREY S",106000,165000,59000
R137248,"KIRK,MICHAEL R","MARSHALL,TIFFANY A",148000,207000,59000
R337098,"WALTERS,JAN","LORD,HARRY S &",126200,185000,58800
R133387,KONDAUR CAPITAL CORP,"MACDONALD,LAUREL B &",145200,204000,58800
R335402,"LEONG,PAK &","FLORES,DANIS M &",89000,147500,58500
R274263,"GUTHRIE,DOUGLAS L","FORMAN,MICHAEL L",108500,167000,58500
R310726,"LEONG,PAK &","NISSL,AMY C",96500,154900,58400
R159089,"LEONG,PAK","RIVERA,ENRIQUE &",102000,160000,58000
R226630,"CLAUDIO,JESUS",CHUCK STRINGHAM RETIREMENT FUND,205000,263000,58000
R266108,L & R STRUTZ PROPERTIES LLC,"DORNEMAN,CASEY J &",277000,335000,58000
R561867,MB & COMPANY LLC,"YU,RUI YU &",85000,143000,58000
R278191,"LEONG,PAK","LAVIOS,ADAM M &",60000,118000,58000
R247191,HUDSON CROSS REO FUNDING X LLC,"SCHLECHTER,SCOTT &",154001,212000,57999
R289867,"CAPLENER,JIM","LE,KHANH &",189053,247000,57947
R297376,PRODUCTION CREDIT,"HOBRECHT,TAMMY",126957,184900,57943
R151351,RP & ASSOCIATES,"TIZON,MARITONI R &",215000,272900,57900
R216934,"LEONG,PAK &","CORNELL,SHANNON",97000,154900,57900
R283679,RESTORATIONS BY K & C,"RICHEN,ANGELA &",140000,197800,57800
R237417,TRUE BREAD PROPERTIES LLC,"JOHNSON,ERIC &",154000,211600,57600
R209727,"CHAN,FUK WING","ABBETT,DICK G &",112500,170000,57500
R121803,N HODGE LLC,"LOUDERBACK,MASON A",82500,140000,57500
R218312,"LI,HONGBO","COLASANTI,ANDREW",118500,176000,57500
R225427,"JOHANSON,ERICK T","WITHERS,SCOTT M &",160000,217500,57500
R120567,TRUE BREAD PROPERTIES LLC,"LANDER,JAMES &",92600,150000,57400
R115677,"MERAZ,JESUS","FITZPATRICK,BRENDAN &",160000,217147,57147
R121761,"LIN,HE YOU &","SCHWEND,AMELIA M",97900,155000,57100
R167534,"SWARTZ,CHRISTINA","PARSONS,KATIE E &",230000,287000,57000
R217007,"BUTLER,DANIEL R",WIN WIN PROPERTY SOLUTIONS LLC,78000,135000,57000
R264273,YOUR ESTATE INC,J & L INVESTORS INC,238000,295000,57000
R239896,"ZHANG,XIU XIA","PULLIAM,ELAINE J &",102000,159000,57000
R264689,"LEONG,PAK","GONZALEZ-ALBA,HECTOR &",68000,125000,57000
R167534,"SWARTZ,CHRISTINA",Sale In Progress,230000,287000,57000
R290357,ROSCO REMODELING INC,"MARTIN,ABIGAIL V &",185000,242000,57000
R127410,"LEONG,PAK M","PILKINGTON,MATHEW L &",110299,167000,56701
R155783,RITCHIE DEVELOPMENT CORP,"SCHAUFFLER,SUNIL &",162000,218500,56500
R175003,CONTINENTAL FINANCIAL INC,"HANSON,MERRIDEE",119000,175500,56500
R144843,"ROSENBAUM,MICHAEL L &","LAMBERT,DARCY",73500,130000,56500
R107955,CSD PROPERTIES LLC,"SIMONCINI,JEFFREY K &",205000,261350,56350
R293549,CASTALDO CONSTRUCTION,"BILELLO,ANTONIO J &",120000,176000,56000
R310924,"CLAPA,BENJAMIN","ADJIBOGOUN,LAMBERT",62000,118000,56000
R224835,"FOTEFF,TIM","WILLIAMS,TAD",100000,155900,55900
R202889,"HANSON,JACQUELINE","HAFFNER,MARK W &",584140,640000,55860
R577500,SOLID MANAGEMENT SOLUTIONS LLC,"TRUONG,ANNHIEN ET AL",136661,192500,55839
R225847,BKB INVESTMENTS LLC,"RENFROW,MARY S",71350,127000,55650
R253773,"LI,HONGBO","DEMARIA,DOMENICA A",86000,141500,55500
R132395,"JACOBSON,ROY","KATZMAN,ALICIA V",223500,279000,55500
R263508,"MENIKOFF,ALEC","BARRETT,NATALIE L",58500,114000,55500
R108008,"GASSNER,RICHARD E &","HERNANDEZ,NOEL D",147000,202500,55500
R318947,"CHAMPION,DAVE TR","LINCOLN,CAROL",106013,161500,55487
R109353,"STOCK,BRANT T","FISCHER,TAMSIE H",74550,130000,55450
R245234,"WIRTA,STANTON",CASAS DE LA RUA PROPERTIES LLC,80000,135400,55400
R245234,"WIRTA,STANTON",CASAS DE LA RUA PROPERTIES LLC,80000,135400,55400
R541235,"COTO,J R","NOE,THERESA L",71700,127000,55300
R145525,"LETT,PETER","LAMB,TYLER L &",199900,255000,55100
R179360,"FIELDS,ELIZABETH AMY","MITCHELL,RYAN J &",682926,738000,55074
R110314,"MANNING,NICHOLAS G","ALFARO,GERARDO A &",190000,245000,55000
R216727,"BURNETT,JAMES R","BRISTOW,REBECCA J",70000,125000,55000
R126800,T&A; INTERNATIONAL LLC,"BARTA,PHILIP A",225000,280000,55000
R293552,"LEONG,PAK","CISNEROS-VERDUZCO,FLORENCIO &",110000,165000,55000
R208540,K BREDENKAMP PROPERTIES LLC,"BRUNDEGE,PAMELA",153000,208000,55000
R209986,"FUSSELL,GEORGE","TOWNS,PETER C",75000,130000,55000
R221837,"EDGERTON,ERIK","WILLIS,RYAN P &",170000,225000,55000
R279494,BEAVERTON HOMES LLC,"SWORD,FIONA",120000,175000,55000
R217006,TM REALESTATE SOLUTIONS LLC,"DAVIS,TIFFANI J",120000,175000,55000
R192499,TEEH LLC,"ROBINS,CHRISTOPHER",90000,145000,55000
R116154,"JELEN,JONATHAN &","VALENTI,WILLIAM L &",245000,300000,55000
R227961,"BROUSSARD,WENDY &","WOOD,ROBERT J &",145000,200000,55000
R170945,"POPICK,DANA","STEVENS,ERIC C",135000,190000,55000
R127349,"ANDERSEN,SANDRA G","SLOVIC,STEVEN B TR &",1675000,1730000,55000
R200386,"NUCCIO,ERIN &","CHANG,BRYAN &",665000,720000,55000
R207062,AAV ONE LLC,"BERRIER,JAMES E &",220000,275000,55000
R573825,"NGUYEN,LUAN MINH","NGUYEN,LONG &",85000,140000,55000
R241400,"OLEXA,ROSE A","ESPARZA,BRIAN P",160000,215000,55000
R264853,"JANTZ,RONALD","WALTERS,LACEY &",180000,235000,55000
R309966,"HELM,DAVID","O'LEARY,CYNTHIA A",120000,175000,55000
R289530,BELLAJOUR LLC,"ROOHANI,JULIEN &",365000,420000,55000
R253805,"STROMME,MARK R","HAEFELE,RICHARD D TR &",355000,409900,54900
R531137,"LEONG,PAK","DESMITH,EIREEN C",105000,159900,54900
R194916,"WEISS,KENNETH G &","THRAP,TREVOR W &",135100,190000,54900
R633295,"SCHROEDER,STEPHEN","BARNARD,TROY D &",155000,209900,54900
R293839,JDR PROPERTY INVESTMENTS LLC,"RAMSEIER,JILL B",85130,139900,54770
R116491,"GOOD,HERB","CURRIER,ARTHUR R &",155250,210000,54750
R234091,OREGON HOMEWORKS LLC,"RAFF,MELVIN H TR &",288000,342550,54550
R102328,PORTLAND METRO,"TEUNON,BRIAN K",345450,400000,54550
R206075,"HAZZARD,FRED &","SKRYABINA,NADEJDA A &",182500,237000,54500
R162947,"LEONG,PAK","FARIAS,JUAN E &",105600,160000,54400
R575378,RIDGEWAY PROPERTIES LLC,"HALLIDAY,NICK R",94900,149000,54100
R239415,SPH INVESTMENTS LLC,"TRAN,HUY &",156000,210000,54000
R242060,"DAPP,BRIAN M","SPANSAIL,ZACHARY &",140000,194000,54000
R183739,Y K INVESTMENT GROUP INC,"WEAVER,DANIEL R &",81000,135000,54000
R279201,"FISCHER,LYMAN","CHASE,RICHARD E &",255000,309000,54000
R106795,"THORSTAD,SHAWN &","BRENNAN,MICHAEL &",465000,519000,54000
R326504,"THOMPSON,ERIC M","KHAN,SAMEER UDDOWLA",376000,430000,54000
R107582,"SOLANILLA,JUAN C","PEAKE,BRETT S",206000,260000,54000
R313328,"LEONG,PAK","ANKNEY,LESLIE E",130000,184000,54000
R235588,STOTT CIRCLE LLC,"GARCIA,JENNIFER &",81000,135000,54000
R252933,"WEIL,MARY &","HANSON,CURTIS",165000,219000,54000
R176251,"IVERSEN,KATHRYN","FISCHER,PAMELA R",425000,479000,54000
R334678,"RYDER,JOHN","MOYER,STEPHEN",89000,142500,53500
R104410,RED GAP HOLDINGS LLC,"SELLECK,KIMBERLEY S &",108750,162000,53250
R219570,"BERNHARDT,NATHAN","LIRETTE,LAURA D &",69900,123000,53100
R156566,"BACKSTROM,BRUCE A","BRAY,ANGELLA",325000,378000,53000
R261732,RP & ASSOCIATES LLC,"NOEL,PAUL D",105000,158000,53000
R209739,"LAFERRIERE,DANIEL S &","EASLEY,GREG A",75000,128000,53000
R189103,"SILVER,BENJAMIN","LEIPHON,DENNIS D",270000,323000,53000
R251928,N HODGE LLC,"PARKER,JENNIFER N",77500,130450,52950
R132677,"MCBEE,NATHAN &","BLISS,KIM",109000,161900,52900
R217207,SKYLANE LLC,"LINHARES,OLIVIA M &",94500,147400,52900
R547591,"O'LYNN,CHAD E &","NESSLEIN,KATARINA",197000,249900,52900
R122087,JET INVESTMENTS LLC,"HEMINGWAY,BARBARA",219900,272500,52600
R118758,WESPAC HOLDING LLC,CARRION INVESTMENTS LLC,210000,262591,52591
R285538,"HANCOCK,KENNETH W &","WELCH,DONALD J &",187500,240000,52500
R248858,FAMILY FIRST HOMES INC,"PAGE,BONNIE A",149000,201500,52500
R219562,FAMILY FIRST HOMES INC,"ORR,LYNART &",125000,177500,52500
R290468,"CHIRGWIN,JEFFREY S &","SOWERS,JUSTIN A",180000,232500,52500
R199816,GORILLA CAPITAL CL 6 LLC,"CLARK,BETTY",139500,192000,52500
R251636,"PIPGRAS,MARTIN J","SAUCIER,HANS P",147500,199950,52450
R189252,"ACKERMAN,SYBIL ROSE","CALLAHAN,KAREN A &",475000,527400,52400
R162005,"OLDHAM,GREGORY","RUDD,SHARON K &",115000,167250,52250
R159020,"HUSK,RONALD L &","CAMPBELL,AISHA M &",143000,195000,52000
R169950,"SCHILLING,PAUL W","CABRERAS-ZALDIVAR,JUAN Y",100000,152000,52000
R154887,"THOMPSON,MARVIN R &","CAGE,RAYMOND S",136000,188000,52000
R214241,"LI,HONGBO","LUPU,VICTOR",92000,144000,52000
R178514,BKB INVESTMENTS LLC,"BROWN,SCOTT R &",93000,145000,52000
R104830,"LI,HONGBO","RENWICK,WILLIAM R III &",110000,162000,52000
R197834,EDEN ENTERPRISES LLC,"BERGMAN,MATTHEW A &",308000,360000,52000
R242567,"KILYUKH,VLADIMIR","FURLONG,ANNA N &",91000,142900,51900
R173873,COHAESUS HOLDINGS GROUP 1 LLC,"BOTTKOL,NIKOLAS &",165150,216900,51750
R185351,SPH INVESTMENTS LLC,"HOECK,DWAYNE M II",140000,191500,51500
R205346,CASTALDO CONSTRUCTION LLC,"MCMEEN,BRIAN W &",122500,174000,51500
R114916,"PETERSEN,VERNON E &","WEBB,JAMES H &",187500,238900,51400
R234311,"JONES,DAN","LIVINGSTON,MICHELLE R &",280800,332000,51200
R238279,E STREET INVESTMENTS LLC,"BARNEY,MATTHEW",82000,133150,51150
R293647,"LEONG,PAK","ADAMS,CARRIE A",84900,136000,51100
R133155,BLUE HOMES LLC,"CERUTTI,ADAM Q &",170000,221100,51100
R208961,"DINH,HIEU T","JEHNINGS,GUS C",155000,206000,51000
R241546,ETRUSCAN VENTURES LLC,"PROVINCE,CHARLES M &",279000,330000,51000
R262027,EVEREST HEIGHTS CORPORATION,"LANDRY,MONICA R &",124000,175000,51000
R229334,"MILLAR,DOUGLAS D","SUTCLIFFE,SHAUNNA",72500,123500,51000
R264660,"BRUESCH,COREY M","PARTCH,PRISCILLA K &",164000,215000,51000
R163230,"THOMPSON,CORINNE N","RUSSELL,TIMOTHY ET AL",215000,266000,51000
R101623,"KREUTZ,COURTNEY &","SPENCER,SCOTT S",400000,451000,51000
R206772,TRUE BREAD PROPERTIES INC,"QIU,HAO LI",75000,125900,50900
R113519,"INAHARA,TRACY A","STORMO,JONI",141500,192000,50500
R119744,E STREET INVESTMENT,"BATTILEGA,STEVEN",80500,131000,50500
R557715,BURTON AKERS LLC,"EBERT,WADE N",78645,129000,50355
R178793,DREAM HOME RENOVATIONS LLC,"ANDERSON,STEVEN E &",120000,170250,50250
R225187,"MYERS,RICHARD","SCHMIDT,KATHY R &",94900,145000,50100
R242474,"SCHWINDT,DAVID T","ALBRECHT,RICHARD W &",160000,210000,50000
R189324,WILDE PROPERTIES INC,"MAZZA,JOSEPH B",345000,395000,50000
R183811,"NASH,SCOTT","ROESELER,AMY M &",115000,165000,50000
R315307,"TAFT,CHARLES N &","BOYER,MARK A &",265000,315000,50000
R277415,"CANTRELL,ALANA D","TAMAYO,MAC L",90000,140000,50000
R494280,"LOUIE,MEI Y","HILDEBRAND,KEITH &",125000,175000,50000
R170570,"PETERS,THOMAS W &","DOECKEL,LAURA",289000,339000,50000
R337960,"DIAZ,PEDRO G","MATSUMURA,JOYCE",80000,130000,50000
R298860,"DENBURG,LESLIE H","DENBURG,SCOTT R",400000,450000,50000
R302998,"POUNDER,GRAYSON L","GERDING,KENNETH J &",270000,320000,50000
R143016,"YOST,STEVEN J &","VOGT,ANDREW",200000,250000,50000
R174211,"LEONG,PAK","NGUYEN,HOA PHU THI",80000,130000,50000
R225531,"ALVAREZ,GILBERTO E &","TAYLOR,REBECCA L &",125000,175000,50000
R205047,"HENDRYX,RYAN A","PORTER,GRAHAM",278000,328000,50000
R268602,WILLAMETTE VALLEY,"BONE,MATTHEW G",153000,203000,50000
R174466,ALLEN TRUST COMPANY INC TR,"SCHULMAN,PETER M &",850000,900000,50000
R294894,ORACLE DEVELOPMENT LLC,"JANKOVICH,RICHARD G",225000,275000,50000
R220127,"WOLF,MICHAEL &","WILSON,SEDALIA",230000,280000,50000
R288093,"PHILLIPS,CAROL A","O'NEILL,JOHN J",300000,350000,50000
R208662,"ENGLE,MICHAEL L &","JOHNSEN,CLIFFORD T",201000,251000,50000
R101603,"ROTHROCK,ERIN K &","POLK,SUSAN &",635000,685000,50000
R605395,GOLD LEAF PROPERTIES LLC,"VOLD,LINDSEY A",175000,224950,49950
R209757,"LEONG,PAK","RAMIREZ,EDGARDO O &",130000,179900,49900
R122121,"WOMELDORF,SANDRA H","IVORY,KRISTEN L",200000,249900,49900
R217561,"ALBRIGHT,ALLAN H","VELAZCO,JESUS I",201000,250750,49750
R201911,"WIED,JOHN M","BAKER,KYLE A",144375,194000,49625
R151713,"KEARNEY,JULIE F","GATTO,NICOLE J",104500,154000,49500
R341604,"PATNODE,CHRISTOPHER L &","DAVIS,KEVIN C &",256000,305500,49500
R238417,SPH INVESTMENTS LLC,"SMITH,DANIEL L",145000,194500,49500
R115030,"MORGAN,JACK",CRESCENT CUSTOM HOMES LLC,220000,269000,49000
R575782,MY FINANCIAL WORKOUT LLC,"KONSTAD,KEVIN N &",183000,232000,49000
R172114,OVERLAND RENOVATION LLC,"SOLORIO,UBER",88000,137000,49000
R157373,K BREDENKAMP PROPERTIES LLC,"PACURAR,JASON",165000,214000,49000
R156964,"SCHNEIDER,RICHARD M","LE,SON N &",76000,125000,49000
R121776,"LI,HONGBO &","BURNS,DENISE-50% &",65000,114000,49000
R100864,H & H DIVISION LLC,"KILGORE,KYLE G &",250000,299000,49000
R211738,"SMITH,ARIK","BROWN,DENNIS TR &",102000,151000,49000
R102854,"FRAGIAO,RODNEY &","MOREHEAD,GRANT M",176000,225000,49000
R333826,GET R DONE LLC,"HELD,MARK &",145000,193900,48900
R309506,"MAUNU,WAYNE &","JOHNSON,STEPHEN M &",330000,378850,48850
R276453,"COOLEY,CHERI","ANDRIESIAN,HILARY &",136100,184950,48850
R165954,"CHAMBERS,WILLIAM H &","WBANDO,AMISADDAI JIMENEZ",76335,125000,48665
R213737,"EISELE,HUGH","CHASE,DAVID R IV &",118900,167500,48600
R334484,"GULOSH,JOSEPH P","DUBINSKI,DONNA A",176000,224400,48400
R186283,"PAULSEN,SHARON L","CHEN,BOB &",201500,249900,48400
R124585,WILLAMETTE VALLEY,"CARRIERE,CHARLES E III &",260000,308400,48400
R137411,COTD III LLC,"LARSON,MARTIN J",113370,161700,48330
R276503,"COLER,TRUDY T","BENNER,ELIZABETH J &",236750,285000,48250
R299915,"QUAN,ALEXANDER","BANUELOS,ANJANET",107000,155000,48000
R253883,"ALWORTH,WARREN L JR","COKE-GALLI,MELINDA",167000,215000,48000
R216169,FLORENCE DESIGNS LLC,"LYUBCHENKO,DMITRIY",305000,353000,48000
R279519,K BREDENKAMP PROPERTIES LLC,"LUNDGREN,MONICA JO",115000,163000,48000
R191475,"MELVILLE,CLINTON","REINHART,TIMOTHY A",272000,320000,48000
R597130,CLUNAS FUNDING GROUP INC,"PETRACCI,DAMON",267050,315000,47950
R597130,CLUNAS FUNDING GROUP INC,"PETRACCI,DAMON",267050,315000,47950
R131906,BLUE HOMES LLC,"SWICK,KELLY R",125000,172950,47950
R181176,TRUE BREAD PROPERTIES LLC,"KEMPLE,MARTHA",75100,123000,47900
R217011,"COX,CHRISTOPHER R &","OTREMBA,PARIS",122000,169900,47900
R249573,"LEONG,PAK","FUDGE,TERESA",90200,138000,47800
R242519,FOX CAPITAL CORPORATION,"SAECHAO,KAO M &",94000,141750,47750
R313204,"MEANS,JONATHAN","MEANS,DAMARIS &",427500,475000,47500
R107278,TRUE BREAD PROPERTIES LLC,"ASHURST,SHEILA A",97500,145000,47500
R129823,TRUE BREAD PROPERTIES INC,"ALEXANDER,CHRISTINE A",71499,118950,47451
R110099,UNIVERSITY DEVELOPMENT LLC,"KISER,BRANDON &",177800,224900,47100
R201771,"WESTON,MARILYN J","BLANK,ROBERT B",325000,372000,47000
R561867,"YU,RUI YU &","WELLS,MICHAEL F &",143000,190000,47000
R217027,CHRISTENSEN 401K PLAN,"JAMES,CHRISTOPHER A &",105000,152000,47000
R317763,"FOGELSTROM,BRETTON J","CRAWFORD,JANIS I",195000,242000,47000
R229609,TRUE BREAD PROPERTIES LLC,"DUNCAN,EMILY",173000,220000,47000
R225869,CONTINENTAL FINANCIAL INC,"TYLER,MELISSA A",112000,159000,47000
R498270,"FULLARD-LEO,BETTY","GATES,BRADLEY &",88500,135000,46500
R131388,336 ALBERTA LLC,STEELHEAD CONSTRUCTORS INC,183900,230000,46100
R305400,AAV ONE LLC,"ISHMAEL,VERONICA",138000,184000,46000
R166326,"NASH,SCOTT","MOORE,SCOTT &",176000,222000,46000
R275130,"LEONG,PAK","HIGH,KATHERINE T",119000,165000,46000
R294369,KJ INVESTMENTS GROUP LLC,"GREER,WILLIAM &",205300,251275,45975
R123759,"STEINHOFF,THOMAS T","BOYD,ADAM W &",210000,255900,45900
R213898,TTM CAPITAL FUNDING LLC,"CALARRUDA,HOWARD P JR &",119500,165000,45500
R202710,"BLUMENTHAL,SUSAN","CAMPBELL,JASON &",389900,435000,45100
R270877,"NASH,SCOTT F","PHAN,CONGTAM LE",115900,161000,45100
R231828,PORTLAND DEVELOPMENT GROUP,YAPP RE INVESTMENT LLC,275000,320000,45000
R160260,WILLAMETTE VALLEY,"TOOLE,JOSHUA R &",295000,340000,45000
R593609,"SUNDERLAND,KYRIN","LEWIS,CHRISTOPHER J &",180000,225000,45000
R107275,"DISCIASCIO,PETER N &","KIENHOLTZ,DON",180000,225000,45000
R210228,WHISKEY TANGO INVESTMENTS LLC,"TESTER,APRILLE N &",105000,150000,45000
R264408,OREGON HOMEWORKS INC,"SCHLANSKY,BARRY &",245000,290000,45000
R290499,"LEONG,PAK","TRAN,TAN VAN",135000,180000,45000
R556965,K BREDENKAMP PROPERTIES LLC,"LONG,MATTHEW A &",140000,185000,45000
R503965,"CARLSON,JON &","VACHAL,JEANNE A &",107000,152000,45000
R196583,"RAWLINGS,JIM &","RUBIN,SUE &",255000,300000,45000
R285615,METRO HOMES NORTHWEST LLC,"SKORO,ANTE",150000,195000,45000
R181257,ESTELLE GOULD REVOCABLE TRUST,"ROMPALA,JOHN F &",525000,570000,45000
R137580,GORILLA CAPITAL WA 6 LLC,"SPLIETHOF,AJ &",95000,140000,45000
R121736,WILLAMETTE VALLEY,"ROMAN,JORGE &",145000,190000,45000
R162084,AP PACIFIC LLC,"LECLAIRE,PATRICK J &",160000,205000,45000
R157078,"RUDE,COHN M","STROM,DALE V TR &",265000,310000,45000
R174211,"NGUYEN,HOA PHU THI","MCCORMACK,JESSE L",130000,174995,44995
R176128,RP & ASSOCIATES LLC,"MITCHELL,DUSTIN &",279990,324900,44910
R163970,"MYERS,RICHARD","GOLD,OWEN",85000,129900,44900
R302230,"MILLER,MISAKO &","ROSENBERG,DAVID S &",275000,319900,44900
R107762,PRIORITY PROPERTIES LLC,"BRAINARD,DUANE L &",125000,169900,44900
R207452,"SPANOS,JESSICA &",FIRENZE DEVELOPMENT INC,277400,322000,44600
R116771,"PICKETT,MICHAEL T &","BRADSHAW,MELISSA &",117900,162500,44600
R135686,"POZARYCKI,WALTER","VELASCO,TODD V",185500,230000,44500
R216508,"KURILO,MIKE &","HALL,LEISA C &",323000,367500,44500
R165715,BEAVERTON HOMES LLC,"BROWN,PAUL D",85000,129500,44500
R336226,TALIESIN HOMES NW LLC,"HARVEY,SCOTT P",110500,155000,44500
R113483,"CONDON,ROBERT","POTTER,JUSTIN",105000,149300,44300
R108643,"WALDOCK,K MICHAEL &","CURLEY,MICHAEL G &",395800,440000,44200
R310680,"LEONG,PAK",HABITAT FOR HUMANITY,78950,123000,44050
R236954,"THROCKMORTON,JOHN","TINNEY,JENNIFER L &",305000,349000,44000
R161960,"CHAN,FUK WING","GRAHN,JEREMY",101000,145000,44000
R125841,"LAMARR,JOHN","CRAWFORD,DONALD B",135000,179000,44000
R101792,CSD PROPERTIES LLC,"PRINCE,LYNN",266000,310000,44000
R154661,HAMPTON PLACE LLC,"DASTE,AUTUMN R &",101000,145000,44000
R190949,"BAIRD,CHRIS",IRON BRIDGE MORTGAGE,168625,212533,43908
R178485,SALEM STEWARDSHIP LLC,Sale In Progress,91000,134900,43900
R108871,"LEONG,PAK M","LOWE,JENNIFER M",64500,108000,43500
R217011,"LAYON,CHRIS","COX,CHRISTOPHER R &",78750,122000,43250
R151981,"GILCHRIST,JESS S &","WESTLEY,CAROLINE E",185000,228000,43000
R250055,RGB BUILDINGS INC,"BRUMBELOW,ZACH",215000,258000,43000
R145805,"LEONG,PAK","DANG,LAN THI KIM &",86000,129000,43000
R533736,"STARR,NATHAN F","SKJEI,JEANNETTE",122000,165000,43000
R338435,"LE,ROBERT","MORGAN,MELISSA A",107000,149900,42900
R283530,"LOCKHART,BRIAN K","MARTINEZ,PATRICK &",171200,214000,42800
R234911,PIERCE INVESTMENTS LLC,"BRAMBILA,GERARDO",175000,217500,42500
R227203,"PRIEST,PATRICK H","PEARSON,SARA L",182500,225000,42500
R113298,"POLK,SUSAN","GREVSTAD,ROBERT M &",314000,356500,42500
R332308,"BEAM,DARRELL &","DELEON,DIXIE",80000,122400,42400
R230896,"CARROLL,JOHN F &","BLOUNT,MARVIN &",430000,472157,42157
R328835,"PARK,KEVIN &","LENAR,DAVID P &",319900,362000,42100
R114433,"HARRISON,GINGER G","RODRIGUEZ,MIGUEL",315000,357000,42000
R252081,"MYERS,RICHARD A","STARR,MICHAEL &",110000,152000,42000
R217011,TRUE BREAD PROPERTIES LLC,"ZEPEDA,LOTICIA R",146000,188000,42000
R265417,"TRAN,TRAM","ORELLANA,RAFAEL E &",150000,192000,42000
R158495,"PIERONI,ROSE","TSERING,LHAKPA &",241985,283900,41915
R314363,FIVE NS LLC,"KAUFMANN,MATTHEW W",108000,149900,41900
R160305,"EDMONDSON,JEFF","HELLWEGE,JESSE",142000,183850,41850
R228976,"ALBERT,JOSEPH &","ROOT,HELENA B &",106600,148200,41600
R298674,"BREDENKAMP,KING","TRAFF,PAULA &",112000,153500,41500
R292806,"GOUGHNOUR,JERAD",RP & ASSOCIATES LLC,91000,132500,41500
R258612,CROSSROADS CHURCH OF CHRIST,"CASSARINO,ANITA &",165500,207000,41500
R268500,HUDSON CROSS REO FUNDING X LLC,"SERNEELS,ADRIENNE M",168677,210000,41323
R108314,PDX REDEVELOPMENT LLC,"CHENVEN,NORMAN &",215000,256000,41000
R102962,FD PROPERTIES LLC,SAPUNAR FAMILY EXEMPT,158000,199000,41000
R264156,"BRYAN,SETHYN L","DUNLAP,MARK F",205000,246000,41000
R118902,"WILDT,CHRISTOPHER A",METRO,409000,450000,41000
R116386,"RIGGS,JUDITH R","WAINWRIGHT,DONALD &",47250,88000,40750
R547605,"LUCUS,ERIN &","NOSEWORTHY,WILLIAM L",96750,137000,40250
R173835,"UPFELD,ERAN &","MACFARLANE,MICHAEL J &",175500,215600,40100
R319617,"MYERS,JAMES S","GARCIA,CHRISTIAN",149900,189900,40000
R268844,WILDE PROPERTIES INC,LMP ACQUISITIONS II LLC,305000,345000,40000
R163882,SKYLANE LLC,"PROCTOR,DARALYN R",235000,275000,40000
R163882,SKYLANE LLC,"PROCTOR,DARALYN R",235000,275000,40000
R491239,"LEVY,SHABTAY TR",LULU INVESTMENTS LLC,140000,180000,40000
R220167,LDZ INVESTMENT LLC,"LIU,CAROLINE &",95000,135000,40000
R227610,METRO HOMES NORTHWEST LLC,LMP ACQUISITIONS II LLC,185000,225000,40000
R130898,"ARNOLD,JOHN D &","COX,ELIZABETH H",215000,255000,40000
R109420,CONTINENTAL FINANCIAL INC,"SHEPPARD,LAURA J",93000,133000,40000
R290777,"CHAN,EVAN","KING,ALEXANDER R",150000,190000,40000
R323868,MERIDIAN EQUITIES LLC,"COFFEY,ERIN M",495000,535000,40000
R226576,"HOVLAND,THOMAS &","O'CONNOR,NICOLE",210000,250000,40000
R226175,KEYSTONE LLC,"OZERUGA,RUSLAN",150000,190000,40000
R218182,J & D RENOVATIONS LLC,TERESA CHARITIES INC,210000,250000,40000
R327541,"HIBBEN,BRANDY","TOYOSHIMA,AMY S &",410000,450000,40000
R241993,CITY REDEVELOPMENT2 LLC,"SIMONDS,JENNIFER",160000,200000,40000
R126679,"CONLEY,LAUREL A","MCCLURE,RICHARD L",190000,230000,40000
R120268,"LEONG,PAK","PREISCH,HALLE M &",100000,139900,39900
R123825,MY FINANCIAL WORKOUT LLC,"ALBAUGH,ELIAS B",183300,223000,39700
R249639,"MCCAW,MATTHEW &","MELL,JOHN A",135000,174600,39600
R295134,GOOD DAY LLC,"RUBER,MICHELLE &",218500,258000,39500
R250031,"HALFORD,JOYCE &","SHUTE,DEANNE M TR",230000,269500,39500
R107774,"BENDIS,INA K TR","GROTTON,NANCY J",210000,249500,39500
R108951,WILLAMETTE VALLEY,"NEIL,ADAM F",145576,185000,39424
R531290,"BURDEN,STEVEN &","PEACH,DUNG",150000,189350,39350
R216160,"MUSSER,GARY L TR","MARTIN,TERRY K",201800,241000,39200
R176709,"NAM,HYUNG K","ROBERTS,MICHAEL J &",229900,269000,39100
R284526,"DYSON,ROBERT D TR","KORNEEVA,NATALIA",375000,414000,39000
R106372,ROSCO REMODELING INC,"ION,BOGDAN &",141000,180000,39000
R211011,"KENDIG,CHARLES &","NGO,MINH H",226000,265000,39000
R253217,"SCHMEER,STEVEN P &","LINNE,CAROL &",420000,459000,39000
R129710,"NUSSBAUMER,BENNY L","CHURCH,CHRISTOPHER J &",151000,190000,39000
R303273,"GALKOVSKI,NATALIA","HOFFMAN,JEFFREY C &",146000,185000,39000
R164408,RW FULLERTON CO,"MENZEL,JOHANNES",87500,126000,38500
R243893,"LONG,MARK S","MILLER,MICHAEL A",225000,263500,38500
R551388,TRUE BREAD PROPERTIES INC,"DEMPSEY,GARY",58726,96760,38034
R298031,ASPIRE PROPERTIES LLC,CHERRY TREE INVESTMENTS,177000,215000,38000
R211873,"BROWN,LISA",WCPC LLC,127000,165000,38000
R138036,"COPENHAGEN,LEE &","JOHNSON,ALEX H",372000,410000,38000
R242315,"NASH,SCOTT F","RICE,STEPHEN L",110000,148000,38000
R185778,"HAMBERG,LEON G","WEST,WADE E &",159000,197000,38000
R116621,BASIS INVESTMENTS LLC,"CULBERTSON,LARRY L",119000,157000,38000
R195045,"VERNIER,PETER J","GAYLORD,MELISSA",211000,249000,38000
R292773,HABITAT FOR HUMANITY,"DIMAS,AUSTIN R",165900,203874,37974
R310633,SPH INVESTMENTS LLC,"KWOK,ANGELA FANG &",140000,177900,37900
R155463,"CLARREN,REBECCA P","AGUILAR,JENNIFER M &",287500,325000,37500
R179560,THREE ARCH INVESTMENT FUND 1,"HARDT,DANIEL &",72450,109900,37450
R142219,ROSCO REMODELING INC,"SAGE,KRISTEN",168900,206000,37100
R592257,"WEBER,ERIC &","HASELNUS,GARY M &",279950,317000,37050
R273641,"HAMILTON,PRESTON","O'BRIEN,ELIZABETH &",180000,217000,37000
R272750,"SIMMS,KENNETH","BUCHHOLZ,WESLEY A &",263000,300000,37000
R224813,AAV ONE LLC,LE CITADEL INVESTMENTS LLC,73000,110000,37000
R202673,CJC PROPERTIES LLC,"DAWKINS,CHRISTOPHER D &",450000,486500,36500
R242297,A GREEN ACRE LLC,"WILLRETT,CHLOE W &",140500,177000,36500
R565764,"NEVINS,SHARON M","PROCTOR,WAYNE G",86000,122500,36500
R258945,"EBERT,STEVE W","HOLMAN,RICHARD J",167500,204000,36500
R184393,"CHU,KWOK SING &","RAMSEIER,JESSE &",249900,286250,36350
R259700,"BEHR,SARAH","LANDERS,DOUGLAS K &",363000,399300,36300
R258715,BEAVERTON HOMES LLC,"SKOURAS,KONSTANTINOS K &",110000,146000,36000
R153559,FOX CAPITAL CORP,"SMITH,ANTHONY P",72000,108000,36000
R131325,UNIVERSITY DEVELOPMENT LLC,ASPIRE PROPERTIES II LLC,180000,215950,35950
R241980,"NGUYEN,CACH &","PERRY,STEPHEN C TR &",112500,148000,35500
R243102,"XIONG,FOUA &",METLIFE HOME LOANS,213900,249243,35343
R114095,"SKURSKI,KEVIN &","KIRKPATRICK,WILLIAM D JR &",485000,520000,35000
R282644,"VOGEL,MARILYN R","HAAR,EDWARD J &",340000,375000,35000
R265851,JET INVESTMENTS LLC,"CATALANO,DESIREE A",125000,160000,35000
R276871,"KNAPP,LAUREL","LYDGATE,CHRIS J &",565000,600000,35000
R103409,"WICK,MEGAN R &","CARESS,DAVID R &",273000,308000,35000
R189105,"ZIRKER,VIVIAN","NEWBERRY,WARREN",415000,450000,35000
R296377,DIVERSIFIED INVESTMENT,"SMITH,EVELYN E &",185000,220000,35000
R239115,"VIELMETTI,WANDA F","TEAL,TYRONE T &",145000,180000,35000
R172180,"AKERS,MARY &","SIEDLECKI,MICHAEL",190000,225000,35000
R265851,JET INVESTMENTS LLC,"CATALANO,DESIREE A",125000,160000,35000
R292250,"SANDERSFELD,JOHN",HIJ PROPERTIES LLC,250000,285000,35000
R337949,D & P HOLDINGS LLC,"DUFEK,JOSEPH B &",110000,145000,35000
R146276,"KREMER,NORMAN T &","BAUER,QUINTIN &",160000,195000,35000
R278212,"TRAN,RUBY &","WERTS,MICHELLE K",77100,112000,34900
R232631,SILEX DEVELOPMENT LLC,"MICKMAN,MAEGEN A",110000,144900,34900
R295412,"LEHMANN,KRISTINE E","COLEMAN-FIRE,BETHANY &",435000,469900,34900
R287351,TRUE BREAD PROPERTIES LLC,"GARCIA,NICOLAS H",161500,196350,34850
R281046,"ROMBERG,JULIE A TR","POLITES,CHRISTIANA S",437500,472000,34500
R208218,T T M FINANCE LLC,RIDGEWAY PROPERTIES LLC,130600,165000,34400
R221562,"WOLF,SOLOMON","DAHBOUR,PAUL S &",245700,279995,34295
R241067,"GOUGHNOUR,JERAD","BUTTS,GARY L &",109700,143900,34200
R532910,"POPICK,DANA L","DUONG,MINH H",81000,115000,34000
R240545,"SOLIS-PENAFIEL,CUITLAHUAC &","GUERRERO,RAFAEL CEJA &",75000,109000,34000
R207629,"LI,XIAO NING","LI,YE MIN",165500,199500,34000
R111414,K & I PROPERTIES LLC,"GEER,RON L &",93000,127000,34000
R241093,AMY PROPERTIES LLC,"GARRICK,JAMES L",120000,154000,34000
R289502,"RAMSAY,CHARLES S &","OHLSON,ARIK M",171000,205000,34000
R173641,DREAM WORKS DEVELOPMENT INC,"BEIKMAN,STEPHEN R",265000,299000,34000
R220467,"THORNTON,BECKY E &","NORRGARD,MARCIA &",306000,339900,33900
R262943,D & I PROPERTIES LLC,"SICHAMPANAKHONE,PHAIVANH &",131000,164900,33900
R277552,"KRAUS,CRISTY J","WOOLSEY,PATRICIA H",226500,260000,33500
R102793,"WEHRLEY,THOMAS G &","HORTON,GARY D",285000,318500,33500
R242035,"PETERSEN,WHITNEY A","NICHOLSON,RYON J",216500,250000,33500
R156927,"ENSIGN,HOLLY","LOVERN,DREW M",85000,118000,33000
R218878,"BOOTH,JASON N &","SHAH,MAULIN P",600000,633000,33000
R271622,"BIRNBAUM,STANLEY &","THORNTON,ROBERT",268050,301000,32950
R102862,"MC ELLRATH,JASON","COOLIDGE,MINDY A",177000,209900,32900
R303976,"STEELE,DAVID",BLEECKER & PERRY LLC,232996,265800,32804
R217125,"DINH,HIEU THANH &","SPASOVA,ANNA A",54320,87000,32680
R248526,REALPDX LLC,"GRIFFITH,PATRICIA J &",142400,175000,32600
R597942,TRUE BREAD PROPERTIES LLC,"SHELLITO,LISA M",140000,172500,32500
R205340,"REYNOLDS,DAVID TR &","GORTON,STACY &",145000,177500,32500
R498083,"YANG,YINDI &","SYCK,JUSTINE E &",190000,222435,32435
R481762,EWCP LTH FUND LLC,"LECHNER,STEFANIE S &",167500,199900,32400
R108273,"HEINEY,ROBERT","BUI,HIEN &",121200,153500,32300
R198880,"STRAUSS,SHAWN","HURST,SAWAN A &",189950,222000,32050
R199964,"LEONG,PAK","TRAN,HANH THI",95000,127000,32000
R153294,"GARN,CYNTHIA G TR","JANIFER,SETH",120000,152000,32000
R121572,"FUSSELL,GEORGE","MORRIS,BEVERLY J &",53000,85000,32000
R269790,"JOHANSON,ERICK &","OLIVA,THERESA &",170000,202000,32000
R191800,"LIU,FENG-LING &","TRAN,HUE D T &",168000,200000,32000
R327541,"HIBBEN,BRANDY","TOYOSHIMA,AMY S &",410000,441900,31900
R302912,"LUSE,BRIAN K &","ANDERSEN,WAYNE G &",275500,307000,31500
R134067,"WICK,BRANDON &","MICKELSON,RYAN A",227000,258500,31500
R517337,"LAYON,CHRIS &","TUCKER,ERIKA &",122500,153750,31250
R262505,"TRIPTOW,ROBERT J &","SANKER,HEIDI",369900,401000,31100
R165687,"NGUYEN,MAI","NGUYEN,ANNA",67000,98000,31000
R144255,"JONES,MICHAEL T","CARTER,ARA J JR",89900,120500,30600
R121820,"STONEROAD,HOLLI S","MLODOCH,ANDREW J &",136900,167400,30500
R307499,"OLSSON,DON &","HAYES,SMITH P",369525,400000,30475
R240457,ORCHARD TERRACE ESTATES LLC,"REPP,DAVID",94500,124900,30400
R574805,"KYTE,ROBERT E &","FOLEEN,LORI A",119900,150000,30100
R204931,"CLAWSON,MARK R &","CLAWSON,MARK R &",269990,300000,30010
R326577,EDEN ENTERPRISES LLC,RENAISSANCE CUSTOM HOMES LLC,370000,400000,30000
R532133,"LEONG,PAK","GATES,JESSICA A &",100000,130000,30000
R221727,FASTRACK REDEVELOPMENT LLC,RD STARK HOLDING CO LLC,80000,110000,30000
R308430,EQUITY INVESTMENTS LLC,WEST COAST REAL ESTATE,220000,250000,30000
R245219,EAGLE PROPERTIES LLC,"SKORO,MATE",88000,118000,30000
R229444,"CREVER,CHRIS","DILLARD,TROY H",150000,180000,30000
R114382,PCLT DEVELOPMENT LLC,PROUD GROUND,136000,166000,30000
R107973,"MAES,FLOYD A","RUHLAND,MATTHEW P",140000,170000,30000
R189323,"HORNER,RODRICK","HUME,GREGORY R TR",330000,360000,30000
R203293,HAND OF DIAMONDS LLC,REAL VALUE HOMES,345000,375000,30000
R109324,"DINH,ROMA","DINH,TOMMY",145000,175000,30000
R266445,"JACOBSEN,VAGN TR &","WICKWIRE,TOBY J &",320000,350000,30000
R113454,"HANNA,DELBERT P &","LUCAS,SCOTT D",149000,179000,30000
R109907,"BLATT,PHILIP &","ERICKSON,ROBERT S TR &",370000,400000,30000
R233074,"WILKINSON,JAY &","MCBRIDE-SMITH,ADAM &",180000,210000,30000
R120938,"GRIMWOOD,BRIAN TR","NGUYEN,PHUONG MINH &",150000,179900,29900
R130806,MS LLC,"STROM,THAI",140000,169700,29700
R165584,"SUN,YUNLONG &","WANG,WEIRONG &",495400,525000,29600
R277048,"BETZ,THADDEUS &","ELLIS,HAYLIE Z &",515500,545000,29500
R541209,"SATRE,STEVEN &","DAWSON,ALLISTER S",278000,307500,29500
R481995,ORCHARD TERRACE ESTATES LLC,"QUIN,ANDREA C",73500,103000,29500
R264793,"MATHEWS,JACQUELINE L-2/3 &","MALSTROM,CAMERON A &",166500,195600,29100
R124763,"BROWN,BRITT C &","DORSTAD,HEIDI &",349900,379000,29100
R222331,EQUITY TRUST COMPANY CSTDN,"FAGO,WESTON C",150000,179000,29000
R341410,"FOWLER,MICHAEL R TR &","CUPPER,HENRY A &",101000,130000,29000
R106235,"LI,HONGBO","CABRAL,ISIDRO &",84000,113000,29000
R153641,"BERNHARDT,NATHAN","O'HICKEY,JOSEPH J",115000,144000,29000
R252747,"WOODS,EUGENIA","JORGENSEN,BRYAN K &",650000,679000,29000
R289129,"NEDELISKY,MICHAEL","CIENFUEGOS,KRISTINE M",230000,259000,29000
R223998,"MARTINEZ,JOE A &","ANDERSON,JAMES E &",175000,204000,29000
R213499,"SHEPARD,AMOS","FARIS,STUART",196000,225000,29000
R296636,"LYON,SUSANNA K","GODFREY,JAMIE LEE",206000,235000,29000
R290087,SWING SET DEVELOPMENT LLC,"KOLL,RICHARD L",245000,273900,28900
R217009,RP & ASSOCIATES CONSTRUCTION,"YOUNG,RODNEY V",126100,155000,28900
R177480,"OKULITCH,GEORGE P &","LUCUS,ANDREW T &",371000,399900,28900
R226834,KIMCO PROPERTIES LTD,"HART,ALISON K",298000,326800,28800
R522228,TREND PROPERTIES LLC,"PICHETTE,MELISSA S",250000,278700,28700
R248769,HABITAT FOR HUMANITY,"MOFFA,DIANE",134900,163573,28673
R126525,"SHEN,XIAOYU","TRINH,STACI MAI &",86900,115000,28100
R107261,N HODGE LLC,"HO,DANH THANH &",92000,120000,28000
R215383,GORILLA CAPITAL WA 6 LLC,LMP ACQUISITION LLC,205000,233000,28000
R108294,WBC INVESTMENTS LLC,"HUANG,PAUL WEISHENG",100000,128000,28000
R163756,"ADAMS,DENNIS",8224-8230 NORTH WILLAMETTE LLC,135000,163000,28000
R128045,EDEN ENTERPRISES LLC,"COREY,JONATHAN M &",212000,239900,27900
R294150,"SHERLOCK,MICHELE L","WINGERSON,GEORGANN D &",260000,287900,27900
R498144,DTF LLC,"ONG,BETTY N &",67200,95000,27800
R151343,FAST CASH HOUSEBUYERS LLC,FOX CAPITAL CORP,137500,165000,27500
R183209,"TRAN,KEVIN S &","VU,ANH H",212500,240000,27500
R126551,ORCHARD TERRACE ESTATES LLC,"ONG,MATILDA CHAI MEI &",55650,83000,27350
R291916,THE MISSISSIPPI DEVELOPMENT,"AMICO,DARRIN P &",259900,287000,27100
R267833,"ISHIDA,TERRENCE TR","LEE,RUSSELL A &",523000,550000,27000
R312060,"PARRET,TIFFANY L","GOODRICH,JESSICA F",190000,217000,27000
R161624,"ROMAIN,CARIE","GUERICKE,MATTHEW &",139900,166882,26982
R273610,"STEENSON,CHRISTOPHER M","BAUER,BRITT L &",258000,284900,26900
R169560,"ROGERS,MOLLY C &","SMITH,LEANDRA",375000,401700,26700
R108121,"HRABAL,DAVID S","SMITH,JEFFREY L",161350,188000,26650
R265721,"NOBLE,C RICHARD &","LANNING,STEPHEN II &",330000,356500,26500
R110490,"HOESLY,WILLIAM","DALTON,MERRITT",215000,241500,26500
R591359,"KERNER,HELEN L &","BLACK,PAUL W &",272500,299000,26500
R159144,"KRAVETS,STANISLAV &","DAVIS,RICHARD D &",155000,181500,26500
R195727,"KENT,JASON J &","BROWN,JOSEPH C &",404900,431000,26100
R166482,"OLSON,SCOTT","SHERWOOD,ANNE D &",224000,250000,26000
R111155,"CROWE,TROY &","ALLEN,STEPHEN",499000,525000,26000
R202850,"MC LAUGHLIN,MICHELLE","KAST,BARRY S &",549000,575000,26000
R556991,"MCCLUER,SCOTT E &","MASSEY,TYSON J",214000,239900,25900
R301826,KJ INVESTMENTS GROUP LLC,"FERGUSON,SCOTT W",128100,153719,25619
R185529,"MOUNTS,CAROLYN","AASE,STEPHEN C &",304500,330000,25500
R296466,DIVINE PROPERTIES 2 LLC,"PICHARDO,AMY",115000,140500,25500
R239067,"SMITH,PATRICIA J &","URIBE ARECHIGA,DIONICIO &",209900,235000,25100
R574814,"RODARTE,JASON &","HERIGSTAD,KRISTIN B",124900,150000,25100
R284011,"LIN,HE YOU","NGUYEN,VIET D",149900,175000,25100
R312358,"HART,GARY E &","CASTLE,CLAYTON F &",399900,425000,25100
R575687,NSI INVESTMENTS LLC,WOLF & SON CABINETMAKERS LLC,225000,250000,25000
R171940,EDEN ENTERPRISES LLC,REDEMPTION HOUSE BUYER LLC,140000,165000,25000
R199351,"FLYNN,MICHAEL",EWCP LTH FUND LLC,85000,110000,25000
R505644,"KASTER,FRANCES L &","REANEY,TADD M &",355000,380000,25000
R284701,"KAUFMANN,AIMEE L","EVANS,KYLE P &",214000,239000,25000
R292074,"SONSHEIN,MICHAEL",H & L PROPERTIES CO,165000,190000,25000
R335587,"QUAN,ALEXANDER","MITCHELL,ANN &",54000,79000,25000
R195561,"LABUNSKY,EUGENE","HORNER,RODRICK &",300000,325000,25000
R123949,"JONES,JUDITH C","RENCHER,RACHEL",300000,325000,25000
R177830,"ENSIGN,HOLLY","HENRICKSON,SHERRY",110000,135000,25000
R267759,"PETERSON,CRAIG J","WAYNE,DONALD H",425000,450000,25000
R645816,"SEWELL,MARILYN","HALLADAY,SUSAN",295000,320000,25000
R248950,STAI ENTERPRISES INC,"SONNIER,BRENDA",240000,265000,25000
R240859,"VARHAN,SAMUEL &","SANFORD,DOUG &",210100,235000,24900
R193857,"JENNINGS,FORREST G &","MOCKFORD,PAUL A &",330000,354900,24900
R137224,"BOURQUE,PIERRE &","BAGAI,ZUBIN",200000,224900,24900
R155815,"MORGENS,ANNE","ROTSTEIN,ALAN L &",321400,346000,24600
R271312,"FARR,E MATT",VIBE DEVELOPMENT LLC,425500,450000,24500
R261253,"PORTER,JEFFREY A","ANNAMALAI,MALER V &",300000,324500,24500
R310739,"POWICK,CAROL","FILIPPONE,MONICA N",130000,154500,24500
R154067,"WELP-LEIGHTON,LAVONNE","SAUNDERS,LANCE",125000,149460,24460
R185793,"DEMING,WILLIAM A III","KENNEDY,RENEE D &",68250,92370,24120
R338409,GOOD FAMILY REAL ESTATE LLC,"DOBBS,GARY L",138000,162000,24000
R602460,"HOLMSTRAND,PHILLIP &","QUINN,LAURA D",322000,346000,24000
R207546,"AHRENS,BERGEN","WILLIAMS,BRANDON N &",63500,87500,24000
R194615,"SCHNEIDER,MATT","LEWIS,DEBORAH",451000,475000,24000
R114787,"MARTIN,JAMES D &","GARAY,MARTON &",415000,439000,24000
R175263,"EDENS,ALVIN D TR &","DIAZ,LEONARD J",325000,349000,24000
R517337,NW PROPERTY WHOLESALERS LLC,"LAYON,CHRIS &",98956,122500,23544
R121562,FOX CAPITAL CORP,PROPERTY OWNER,52000,75500,23500
R491243,"MARTINE,MICHELLE L","RODMAN,HELEN M &",264000,287400,23400
R567962,"JOHNSON,KATHRYN &","WEST,JENNIFER A",386800,410000,23200
R279464,FOX CAPITAL CORPORATION,"MOYE,SAMUEL A",178000,201000,23000
R123707,"PETERSSON,ANN G &","DAVIS,SCOTT A",295000,318000,23000
R290867,HALO ENTERPRISES LLC,"BENDER,PAUL A",309900,332900,23000
R274319,"JOHNSON,BETH A","GADBOIS,JAMES &",315000,338000,23000
R141858,"LEON,MICHAEL","MATTHIAS,JONATHAN &",419000,442000,23000
R309880,TRUE BREAD PROPERTIES LLC,"AHERN,JOHN L",134600,157300,22700
R303096,EMERALD VALLEY DEVELOPMENT LLC,"PRICE,R KENNETH",132300,155000,22700
R342188,"POLK,JOHN","BASELER,JARED",150000,172500,22500
R597942,TRUE BREAD PROPERTIES LLC,"DAVIS,ELLEN P",140000,162500,22500
R262052,JL PROPERTY ACQUISITION 11,"VO DANG,MONICA",37500,60000,22500
R262052,JL PROPERTY ACQUISITION 11,"VO DANG,MONICA",37500,60000,22500
R120857,BOISE STREET,"KELLER,TODD M &",90000,112500,22500
R144756,EWCP LTH FUND LLC,I&N; CONSTRUCTION INC,80000,102500,22500
R183466,"BUCKLEY,CHRISTINE F","ROHOL,SUSAN E",485000,507500,22500
R221016,"KUMMEL,MARC S &","EBERHARDT,JAMES P &",249900,272000,22100
R334297,"LIN,HE YOU &","RICHART,BRIAN &",108000,130000,22000
R307712,"RUTKOWSKI,AMANDA H","NEUDAUER,NANCY A",443000,465000,22000
R108317,"HINTZ,CAROLYN","BULKA,MARK E",173000,195000,22000
R160034,"CUMMINS,PATRICK B &","ELWELL,JAMES R",230950,252900,21950
R185188,"WHITE,ROBERT A &","WEBER,BROOK R &",398500,420000,21500
R338054,"MOSKALENKO,VALERIY &","FROMAN,WESLEY F",127000,148500,21500
R100440,FOX CAPITAL CORPORATION,JOPTA HOLDINGS LLC,80500,102000,21500
R488499,"FRITZ,THOMAS &","HEDLIND,DONNIE R",185500,207000,21500
R224417,BELLAJOUR LLC,"BELLOS,ALEXANDER J &",521300,542500,21200
R619451,"JOHNSON,TRACY W","GARCIA,ROBERT JR &",149000,170000,21000
R279723,"WHITE,ONIE &","WHITE,WARD &",77000,98000,21000
R174372,"WILSON,JEFFREY D JR &","MILNE,HOLLY",429000,450000,21000
R250800,"HAWLEY,WILLIAM &",VIKING HOLDINGS LLC,99000,120000,21000
R291225,"MURPHY,JOHN M &","LAWRENCE,ERIK &",400000,421000,21000
R279055,"KOHLS,DAVID A TR &","HELGERSON,JOSEPH &",269000,290000,21000
R241907,"BEACHELL,LINDA","TAYLOR,DANIELA",195000,216000,21000
R191759,"WALLACE,SHARON","YATCHMENOFF,DIANE",365000,386000,21000
R328181,"SANDER,DAVE &","FRALEY,ROBERT A &",259250,280000,20750
R279015,"JOHNSTON,WILLIAM R &","YOUNG,PATRICIA J &",321550,342000,20450
R632412,"DISCIASCIO,JOE","CARR,JOSEPH",144900,165000,20100
R299536,"SALMON,JAY S &","LIPSEY,STEVE &",424900,445000,20100
R334676,"BROWN,LISA",WCPC LLC,69900,89900,20000
R108012,FOX CAPITAL CORP,"FOSTER,KATHLEEN J",125000,145000,20000
R335777,"SAMSON,NANCY","WATKINS-NEFF,DONNA R &",140000,160000,20000
R102885,"YANG,BENJAMIN","PATTERSON,PATRICK &",320000,340000,20000
R159995,WILDE PROPERTIES INC,EVERETT CUSTOM HOMES INC,190000,210000,20000
R208645,"JOSLIN,RICHARD","FELTZ,LAURA J",420000,440000,20000
R240251,"BASSETT,ANTHONY L","HUTWAGNER,BRETT EA",107500,127500,20000
R269132,"BERNHARDT,NATHAN",STEADFAST PROPERTIES LLC,110000,130000,20000
R246678,SALMONBERRY CANYON LLC,"MCCULLOCH,ANDREW &",500000,520000,20000
R556949,"VERMEER,DONALD E &","PALMER,JOSEPH W",140000,160000,20000
R652169,"GIALANTZIS,PETER M &","MEHTA,AMIT",500000,520000,20000
R307603,"PYRCH,KELLY A &","O'BRIEN,GABRIEL &",325000,345000,20000
R259295,"SEEMAN,BARRY I &","CALLAGHAN,SEAN P &",545000,565000,20000
R123233,"CARSON,CAMILLE &","COOK,JUSTIN &",799000,819000,20000
R176695,"WILLIAMS,SCOTT &","ELLIOT,JOHN C &",280000,299995,19995
R253618,"MOORE,WILLIAM &","JOHNSTON,MINDY K",155000,174983,19983
R579216,"ROTAN,KAREN W &","KELLEY,ALBERT J &",651100,671000,19900
R165954,"HICK,KENNETH W",FEDERAL NATIONAL MORTGAGE,125000,144670,19670
R254079,"MAULDIN,MILTON D &","GATTON,WILLIAM J &",160400,180000,19600
R248401,"GRIGSBY,MICHAEL &","EDWARDS,VANESSA",240479,260000,19521
R137347,DEL REY PROPERTIES LLC,"WINDEDAHL,DOUGLAS S",155000,174500,19500
R300044,"LONG,MICHAEL L &","LIND,WILLIAM L &",250000,269500,19500
R224996,"WHITE,GLENN &","POOL,WILBERT L",165500,185000,19500
R104243,"MC AULIFFE,THERESA D &","RACHFORD,MAUREEN K &",450000,469500,19500
R519360,"WOODNUTT,PEARL &","FARNUM,MIKAYLA",160000,179000,19000
R290189,ARLETA LLC,"BERNERT,JESSICA M",230000,248900,18900
R229543,"FIELD,ROBERT","GARZ,FLOARE",135000,153600,18600
R199626,"GAGUINE,AARON A &","BRITT,REBECCA &",258000,276500,18500
R179446,CASTALDO CONSTRUCTION,"QUILES,ERNESTO GOMEZ",115000,133500,18500
R277839,"MONTGOMERY,MARK A","HOLLISTER,TY L &",254900,273400,18500
R212837,"KHUBESRIAN,LEVON","TRIGUEROZ,LUIS &",108000,126500,18500
R241197,CALIBRATED INVESTMENTS LLC,"MUELLER,DANIEL M",121900,140000,18100
R108360,"MACKEY,STEPHEN D &","BALL,LAURA C",261950,280000,18050
R298680,JACKSON BROS INVESTMENTS LLC,IRON BRIDGE MORTGAGE,95000,113000,18000
R261970,"TOMPKINS,JOHN D &","LOCICERO,MICHAEL",137000,155000,18000
R235788,"RICHARDSON,RANDY R","RICHARDSON,DOROTHY J",227000,245000,18000
R271811,"BELL,MARCIA A","DENTON,JILLIAN L",62000,80000,18000
R138475,SHANNON ACQUISITIONS LLC,BRISTOL CREEK HOMES &,197000,215000,18000
R243035,SMILE PROPERTIES LLC,DEL REY PROPERTIES LLC,190000,208000,18000
R226955,"BERKHEIMER,JAIMASON &",DREAM HOME RENOVATIONS LLC,190000,208000,18000
R160936,"WARNER,RICHARD &","HOWARD,LYMAN E II &",380000,397700,17700
R130543,"MARTIN,DAVID T &","ALLEN,ASHLEY",159300,177000,17700
R280226,HIPP NATIONAL LLC,"ALBRIGHT,ALLAN H",122532,140000,17468
R519438,"MUNDRICK,EDWARD L JR","KIBERT,EVAN A",210500,227900,17400
R337185,"COVACI,SOFIA &","LOZIER,SCOTT",352750,370000,17250
R339196,"PARKER,DIANA","SUSHKOV,NIKOLAY",130000,147000,17000
R135856,"JEPSON,SALLY &","KETTLER,KAREN",177000,194000,17000
R206501,"PIERCE,SANDRA K &","DRUGAN,GREGORY &",440000,457000,17000
R210930,ENCORE DEVELOPMENT,THE ABLETON GROUP INC,92000,109000,17000
R135856,"JEPSON,SALLY &","KETTLER,KAREN",177000,194000,17000
R123686,GLAD HEART LLC,D A GREY LIMITED,68000,85000,17000
R115860,"BARNEY,SCOTT","OUELLETTE,NANCY",348065,365000,16935
R280943,"CUSHMAN,PHILIP R TR &","KEATON,KORINA A",308800,325000,16200
R227858,"MOWLDS,BRIAN","MAZHNIKOV,ANATOLIY A &",210000,226000,16000
R104408,"SORTMAN,SCOTT &","SIMPSON,EDWARD E &",240000,256000,16000
R546064,"DEBRAY,BRADLEY &","DEBRAY,MICHAEL",108000,124000,16000
R336579,"NICHOLSON,JAI",JIMR INVESTMENTS,83000,99000,16000
R234725,HAMPTON PLACE LLC,"CARPENTER,CLIFFORD L",134000,149900,15900
R273641,"O'BRIEN,ELIZABETH &","O'BRIEN,ELIZABETH TR-20% &",217000,232640,15640
R219562,"ORR,LYNART &","ORR,CHRISTOPHER",177500,193000,15500
R312756,"KING,JEFFREY H &","BEESON,JANIS &",449900,465000,15100
R139265,GEZA DEVELOPMENT LLC,336 ALBERTA LLC,250000,265000,15000
R226657,"MEREDITH,ELIZABETH &","WILBURN,LLI TR",270000,285000,15000
R263909,"GONYEA,JENNIFER M","CLARY,KELLY",450000,465000,15000
R254419,"PAYNE,MADONNA","JOHNSON,MARK A &",110000,125000,15000
R188750,"BAXTER,NATHAN E &","DODGE,N P JR TR",1050000,1065000,15000
R109780,"TUYLS,GARY","BUCHANAN,ROY G &",195000,210000,15000
R538064,"RENDA,FRANCIS J TR &","KISER,J STEPHEN TR &",279000,294000,15000
R108539,"CHAN,YIM SUN","SU,JIAN PAN",195000,210000,15000
R280899,"OPSTAD,BRAD T","JENNY,RODNEY D &",367000,382000,15000
R317574,TATAMI LLC,TATAMI LLC-67% &,110000,125000,15000
R326673,"JONES,RICHARD E","MASON,LARK E &",285000,300000,15000
R124275,"CHOU,PHILIP T &","DAVIS,SAMUEL W",80000,95000,15000
R126762,"CARIGNAN,CHRISTOPHER M &","EPPING,CYNTHIA",345000,360000,15000
R218062,"AMUNDSON,EVERETT R &","SULIS,KRISTIN",250000,265000,15000
R198900,"ELLIS,TRAVIS &","MCDONALD,CASEY &",370000,385000,15000
R303865,"SCRUTTON,EUGENE L &","KNEE,JAKE &",385000,400000,15000
R225443,"PHAM,SANG","TRAN,VIET",61000,76000,15000
R267886,DIVERSIFIED INVESTMENT,"RYAN,SHAWN",325000,339900,14900
R542004,"COBB,ANTHONY L &",LUKOVICH DF LLC,295000,309900,14900
R271805,"CLERICO,KIMBERLY","BOONE,LEANNA",36200,51000,14800
R110700,KERR PACIFIC COMMODITIES,"SWANBERG,JOYLENE",150500,165000,14500
R195143,"HOLMAN,FRANK W &","WOOD,CHARLOTTE M &",213500,228000,14500
R113432,"BINGHAM,MARK J","HEATER,RONALD",150000,164500,14500
R259204,HT HOME LLC &,"JOHNSON,CHARLES B",59500,73900,14400
R108533,"MANNY,MICHAEL J &",WELLS FARGO BANK NA,180000,194204,14204
R652132,OREGON HOMEWORKS LLC,DILUSSO HOMES LLC,390988,405000,14012
R529936,"SMITH,DENNIS H","LETA,MIHAI",215000,229000,14000
R217077,"CONDON,ROBERT","ROCHA,JUAN",50000,64000,14000
R311760,"MURRAY,TERRENCE","MCGUIRE,ERIN J &",250000,264000,14000
R178755,"SAILOR,SUSAN","SHELLEY,DANIELLE S",162000,176000,14000
R310770,"WALDSTEIN,VICTOR &","HEFFNER,THEODORE A JR &",93000,107000,14000
R272134,"NGUYEN,LINH","STANLEY,JOHN H &",76000,90000,14000
R340224,"LAMBERT,PAUL","SAFRANSKI,LANCE &",121100,135000,13900
R292833,RP & ASSOCIATES LLC,"BALL,JESSICA R &",192235,206000,13765
R501243,"RICHARDSON,BRYAN &","WHEELER,JEFFREY C &",243900,257000,13100
R331432,"DENTON,WILLIAM A","RASTI,FARIVAR &",274900,288000,13100
R301396,PRIMARK,"SHASTRI,SHOBHNA",320000,333000,13000
R200947,"KING,DENNIS D","BAMRICK,DANIEL E",252000,265000,13000
R241444,"SCHUMACHER,HARRY A","MARTIN,HEIDI S",205000,218000,13000
R263551,"JULISON,MILES","KECK,DAVID G &",210000,223000,13000
R481616,"GARRISON,CRAIG","BALDIZON,BENJAMIN",176500,189500,13000
R301396,PRIMARK,Sale In Progress,320000,333000,13000
R107656,"HIRLEMAN,NANCY L TR","SULLIVAN,KEVIN",254500,267500,13000
R503303,PORTLAND REAL ESTATE,"LIANG,HUI FANG",202000,215000,13000
R229285,"GOUGHNOUR,JERAD","TUREAC,DUMITRU",181000,194000,13000
R266654,"MC BURNEY,PATRICK W &","BENCE,PALJO TR",260000,272995,12995
R502842,"WALSH,MIKE L","FROST,JENNIFER M &",158900,171650,12750
R309406,"MORRISON,DEREK-50% &","MAZZOLENI,DEBORAH &",425000,437625,12625
R249468,SAINT JUDE INTERNATIONAL LLC,NW LANDMARK LLC,106285,118870,12585
R178366,"SALISBURY,JOHN &","BREEDEN,SUSAN L",197454,210000,12546
R207310,EWCP LTH FUND LLC,LMP ACQUISITION II LLC,245000,257500,12500
R162205,"EDWARDS,KENNETH H &","WILSON,EVAN S &",950000,962500,12500
R231567,"MAUTZ,SUSAN C","SPANG,DEENA R",285000,297250,12250
R241492,"DONSBACH,MARGARET J","KNIGHT,CORY",199900,212000,12100
R147127,ACIVRO XESTION S L,"DAWKINS,CHRISTOPHER D",280000,292086,12086
R148250,"MARKUS,CURT &","MARKUS,GABRIEL &",228000,240000,12000
R151402,"ROME,MICHAEL","PORTER,KATHLEEN M",143000,155000,12000
R172570,"SANDERS,BERNARD","FORZLEY,CHRISTINE J &",397000,409000,12000
R134207,"FERNAINE,HENRY &",MORRISON BUILT LLC,375000,387000,12000
R264304,HATCH INVESTMENTS LLC,"MCELWEE,PAMELA JO &",180000,192000,12000
R130968,"SONSHEIN,MICHAEL","NIBLETT,EMMA",183000,195000,12000
R295655,ACIVRO XESTION S L,"DAWKINS,CHRIS",285000,296939,11939
R284048,"EIMER,JOHN J TR &","FARROW,DILLON C",130000,141060,11060
R145523,"HUGHES,JUDSON &","SPENCER,AIMEE &",257950,269000,11050
R231135,"HOLT,ALICIA D","RICHARDSON,MICHELLE D &",215000,226000,11000
R206032,"DEMOY,ROGER W TR &","DEMOY,DANIEL A &",199000,210000,11000
R228556,HAWKEYE FINANCE LLC,"WATERHOUSE,JON",464000,475000,11000
R287192,"GHAZIMAHALLEH,CARRIE","SEARLS,DENNIS L &",201000,212000,11000
R113559,"LARNER,COREY G &","DILLON,ZACHARY &",242000,253000,11000
R132286,"DALY,NIKKI","WILLIAMS,LYNDA J",110000,120100,10100
R106761,NW ACQUISITION &,WYNDYM DEVELOPMENT LLC,310000,320000,10000
R279537,"THOMPSON,MARVIN","ELLIS,CHARLES D &",115000,125000,10000
R610889,"KARIN,DAMIR",EWCP LTH FUND LLC,135000,145000,10000
R226851,FULL HOUSE PROPERTIES LLC,"CUNLIFFE,SUZANNE W",375000,385000,10000
R292835,"CRISP,BERLE &","CRISP,DARBY",180000,190000,10000
R122237,"MURRAY,JAMES R",GPB DEVELOPMENT LLC,210000,220000,10000
R110130,"CALLENDER,ROGER","MEDAK,EDWARD T &",135000,145000,10000
R279537,"THOMPSON,MARVIN","ELLIS,CHARLES D",115000,125000,10000
R106761,NW ACQUISITION &,Sale In Progress,310000,320000,10000
R110696,"PINKSTON,JONATHAN M","ELLIS,CAROL M",227000,237000,10000
R119059,"HARTMANN,RONALD &","HARTMANN,CHELSEA E",165000,175000,10000
R134588,"DYE,CAROL","HASH,RODDY D",280000,290000,10000
R573939,"BILLOW,PETER","CLAYBURGH,DANIEL R &",350000,360000,10000
R199217,"JONES,DON","GARBUTT,AARON D &",259018,268975,9957
R211011,THE BANK OF NEW YORK MELLON TR,"JOHNSON,JONATHAN M &",191250,201000,9750
R143554,"GUILD,DEBORAH M","ROBERTS,MATHEW H",224420,234000,9580
R125152,PETEFARR LLC,"SNYDER,ADAM S &",230404,239950,9546
R123080,"SAILOR,SUSAN","MEECE,ALAN C &",149950,159000,9050
R125004,TRIAD MERIDIAN GROUP INC,"DAVIS,BRADLEY",107100,116133,9033
R262301,"TRINNAMAN,MARY C TR","ALTMAN,DAVID",416000,425000,9000
R132471,"PFEIFFER,NEIL &","JACOBS,SUSAN",220000,229000,9000
R153122,"CAMERON,DEBORAH L","THOMPSON,KEVIN &",360000,369000,9000
R128361,"KROCHAK,HOWARD D","CHASE,MEREDITH M",554000,563000,9000
R179851,"PASCARELL,CHRISTOPHER &","HSIEH,YUNG-CHIN C &",380000,389000,9000
R591081,"CONDON,ROBERT","JACOBSON,TODD A &",225000,234000,9000
R262301,"TRINNAMAN,MARY C TR","ALTMAN,DAVID",416000,425000,9000
R310707,"LI,HONGBO","LEONG,PAK",84000,92820,8820
R305209,"SWEET,J ERIC TR","MOORE,CHRISTIE J",606250,615000,8750
R115144,"BUCK,CHARLES R II &","GARFIELD,GARRETT S &",315000,323600,8600
R240009,"RITZ,SHEILA M &","GILMORE,MICHELLE",145000,153500,8500
R280774,"LINDLIEF,DONALD G &","MCINTOSH,DONALD",374000,382500,8500
R206617,"VATHEUER,HANS J","LAW,ROBERT M",315000,323429,8429
R206616,"VATHEUER,HANS J","LAW,ROBERT M",315000,323429,8429
R282680,PROPERTY RESTORATIONS INC,"DUFFY,DARRELL &",275000,283250,8250
R233527,"OLIGARIO,YANICK","SHULL,SARAH E",262000,270000,8000
R119410,"MOTTA,SAMANTHA &","LOUGHLIN,JOHN M TR &",339000,347000,8000
R144748,"AUSTIN,DAVE","BORSAY,STEPHEN",62000,70000,8000
R281857,"FORD,WILLIAM E JR","TESHALE,DANIEL",195000,203000,8000
R108054,"PROZAKI,MARK E","LEONG,PAK",85000,93000,8000
R159741,RP & ASSOCIATES,"DE MAY,DELANEY",190000,198000,8000
R101569,"YORK,JOHN F &",YAPP RE INVESTMENT LLC,352000,360000,8000
R138251,"SMITH,ALIZ M &","KAZAKOV,PETR",118000,126000,8000
R101627,QUIXOTE INVESTMENTS LLC,"CHAPA,JOAQUIN A &",347500,355000,7500
R156821,"O'KEEFE,MARGARET B","STARK,WHITNEY B &",432500,440000,7500
R293985,FOX CAPITAL CORP,"LEE,SHERWIN SHIANG-REN",70000,77100,7100
R178628,"KING,NOEL &","MASON,JEREMY J",257000,264000,7000
R196955,FAST CASH 4 HOUSES LLC,"MITCHELL,MONICA",150000,157000,7000
R137188,RHODODENDRON ENTERPRISES LLC,"BIGGI,JOHN A &",292000,299000,7000
R336080,"CERVANTES,ARTHUR &","CERVANTES,NATHAN &",191900,198850,6950
R209111,BELLAJOUR LLC,"HALTON,MONET L",335000,341700,6700
R210941,"DALINE,CAMERON &","COLLIER,ABIGAIL A",191000,197500,6500
R186762,"KIRK,ANN &","LARSUEL,JESSICA &",303550,310000,6450
R278868,"KING,MARGARET A","HOFFART,JOSEPH P &",344025,350300,6275
R558690,"NICHOLS,ESTHER","MYERS-SPENCER,KAREN N",163500,169662,6162
R154351,"ECONOMON,SUSAN","GUETTLER,DAVID B &",404000,410000,6000
R203358,DIVERSIFIED INVESTMENT,"RUEDA,KEVIN",419000,425000,6000
R219132,WHITE PINE INVESTMENTS LLC,"ADAMSKI,LORETTA",208000,214000,6000
R335966,"TAFT,KATHLEEN A &","KIMBREL,ANDY &",335000,341000,6000
R166311,"FARRELL,MARK J","BALLANTYNE,ELIZABETH M &",240000,246000,6000
R183076,"WEAVER,ERNEST C","WELLMAN,SANDRA R",209000,215000,6000
R489103,WBC INVESTMENTS LLC,100 ACRE PROPERTY LLC,66000,72000,6000
R334799,"BYBEE,CHRISTOPHER",JULIA LIMITED PARTNERSHIP,194000,199999,5999
R274641,"LEWIS,DAVID &","STEEVES,JON M &",199900,205500,5600
R108186,"NOFZIGER,GARY L","NOFZIGER,BERNARD L",136500,142000,5500
R310559,GREENWOOD BUILDERS INC,"BONDARENKO,VITALIY",110050,115500,5450
R207720,"KOBATAKE,DARIN","FAUNA,AMARI &",124500,129900,5400
R125895,"SOTNIKOV,VLADIMIR &",FEDERAL NATIONAL MORTGAGE,256000,261168,5168
R173598,"HOWARD,GREG M &","GATCHIK,NINA",320000,325000,5000
R278530,"CHAMBERLIN,CHERYL","BARRY,TYLER",175000,180000,5000
R158013,DJ HOLDINGS LIMITED,"BURDEN,ARTHUR R &",275000,280000,5000
R156862,"WHITTAKER,MARK &",SAGE RANCHES INC,370000,375000,5000
R278617,"KECK,EVELYN J TR","RAAB,PAUL V &",310000,315000,5000
R147733,"TAYLOR,CHRIS S","WOLNIEWICZ,GERALD D JR",460000,465000,5000
R242037,WBC INVESTMENTS LLC,"SWANSON,YANEA &",80000,85000,5000
R172728,"CALVANESE,JASON P-38.46% &","LYLES,KERRY &",260000,265000,5000
R143469,ASPIRE PROPERTIES III LLC,"SKORO,MATE",136000,141000,5000
R304481,"SMITH,EMERY","ENGLAND,STACEY L",295000,299900,4900
R251433,"BUI,NGHIA H","NGUYEN,THU NGOC",145255,150000,4745
R188958,"GROVE,PHYLLIS L","DICKENS,WILLIAM H",491351,496000,4649
R186978,"PRESBERG,EDWARD W","KRAMER,JOHN &",312500,317000,4500
R207194,"LUDEMAN,SHANNON T &","MARTIN,COURTNEY E &",325000,329000,4000
R577429,"RISTICK,SYLVIA","CECCANTI,MELBA L",260000,264000,4000
R135832,PFEIFER FAMILY LIMITED,"BRIMM,TERESA G",206500,210500,4000
R161327,"BLUBAUM,BRIAN T","STEELE,DIANE M &",253000,257000,4000
R335005,"DESIMINI,JOHN","LUO,RUSSELL &",110000,113900,3900
R130310,"FRAZIER,THELMA","PELLETIER,LONNIE L &",100000,103812,3812
R216915,RMJ PROPERTIES LLC,MALCOLM INVESTMENTS LLC,101500,105235,3735
R144787,"ROME,STEPHEN &","ROME,EMILY H",145000,148500,3500
R276797,"MANZA,RONALD J &","MANZA,MATTHEW R",95000,98100,3100
R161802,"HARTEL,PATTI D TR","BROSHEARS,KRISTIN &",179900,183000,3100
R231167,PCLT DEVELOPMENT LLC,PROUD GROUND,155430,158500,3070
R153155,"ROSSO,JOHN K TR &","GIBSON,BENJAMIN J &",664950,667980,3030
R189261,"WILLIAMS,SCOTT &","MIRACLE,GRETA L &",376000,379000,3000
R157891,"RODMAN,MAXIMILLIAN",MARDI GRAS HOLDINGS LLC,120000,122889,2889
R131895,"MCMENAMIN,JAMES","HORN,PATRICK L &",158000,160590,2590
R217159,"ADAMS,PAULINE &","KAOHI,TYRAN P",57500,60000,2500
R138617,"SPITZER,RICHARD &","SPITZER,LINNEA A &",202500,205000,2500
R196387,"LAMOTTE,MICHAEL L","KOESTER,STEVEN F &",330000,332500,2500
R334799,JULIA LIMITED PARTNERSHIP,"POLLOCK,DONALD E",199999,202460,2461
R153733,"REMENDER,RICK &",FEDERAL HOME LOAN,277000,279300,2300
R183339,"SPEARING,KENNETH","SPEARING,ANDY",245535,247800,2265
R336029,"MARCOTT,MELISSA A","YOUNG,MARY BETH",177000,179257,2257
R636396,"JENSEN,KARYN","MORALES,JOSE L",161800,164000,2200
R107753,"WILES,JEFF &","WILES,RACHEL",299900,302000,2100
R179567,"CHAN,BRENDA","RUWITCH,SETH J",150000,152000,2000
R274650,"MARTIN,DIANA C","INNS,MICHAEL &",215000,217000,2000
R233520,"TINKHAM,JEFFREY M &","ERNST,WILLIAM M",430000,432000,2000
R193381,FOX CAPITAL CORP,OWINGS-YODER FAMILY TRUST,148000,150000,2000
R155528,"FITZWILLIAM,PETER &","FITZSIMON,ROGER",284000,286000,2000
R297069,"LE,TU","LE,NINH DUC",150000,152000,2000
R300742,"PIZACANI,BARBARA","SANGER,LAURA M",276200,278200,2000
R260592,"QUINCEY,WARD","ROMAIN,DANELLE P",613000,615000,2000
R202067,"GILMAN,LAURRIEN","BARRETT,LEONARD E III &",268000,270000,2000
R332229,"LUNDQUIST,GORDON","LUNDQUIST,AMY",185000,187000,2000
R105864,"RODER,MARC A","SCHUSTER,BRYCE P &",317500,319000,1500
R307735,"HALL,CHRIS P","TALISMAN,MARK E &",423500,425000,1500
R290313,"NGUYEN,KYM","SCHUMACHER,GEOFF",55000,56473,1473
R268997,"GATES,CLARA M","ADDIE,MICHELLE",239500,240932,1432
R329088,BAY POINT PROPERTIES LP,"LAYTON,ELIZABETH F",407000,408275,1275
R313884,WJR LLC,"LOFTUS,KEVIN W",319000,320000,1000
R145581,"FITZGERALD,DAVID J &","RANKIN,WILLIAM &",475000,476000,1000
R222458,"GOLDEN,DON &","WATSON,MAY &",125000,126000,1000
R168796,"BRAY,THOMAS H","KELLY,ROBERT M",35700,36700,1000
R306977,"VAN PELT,MIKE","FISKUM,DARREN",255000,256000,1000
R569889,"FRANK,GEORGE D","HAVELKA,KATHLEEN J",240000,240982,982
R211646,B&E; PROPERTIES LLC,"BIELLO,GABRIEL M &",405000,405844,844
R128408,"MADSEN,MICHAEL","BRADLEY,KARRI K",575000,575609,609
R217183,"SIGMOND,HERBERT A TR","SALZMAN,SHIRLEY",242500,243000,500
R310680,HABITAT FOR HUMANITY,"MAHMOOD,HAZIM H",123000,123345,345
R234399,EXCEPTIONAL HOMES,"MATHIEU,CHRISTOPHER",170000,170130,130
R171204,"ROZENDAL,BRIAN E",COLUMBIA CREDIT UNION,299900,300000,100
R494277,"WEBB,CATHY","WEBB,AMANDA C",149900,150000,100
R222574,"WANG,JENNIFER","LEONG,PAK",111250,111339,89
R141712,"WILSON,JAMES D TR &","WILSON,JAMES D TR &",480000,480000,0
R165662,NSI INVESTMENTS LLC,NSI INVESTMENTS LLC,166750,166750,0
R170178,PRUDENTIAL RELOCATION INC,"EIDEMILLER,LARRY R TR &",386700,386700,0
R249482,"LOW,GERALD DAI SUN","LOW,JODI",154550,154550,0
R165662,NSI INVESTMENTS LLC,NSI INVESTMENTS LLC,166750,166750,0
R166474,"WANG,RUI TENG","WANG,RUI TENG",195000,195000,0
R148028,"BLIVEN,DARRYL J &","BLIVEN,DARRYL J &",300000,300000,0
R285583,"KEHOE,MATTHEW H","BANKS,CHASITY",110000,110000,0
R145679,NATIONAL RESIDENTIAL,"KOEHLER,CHRISTA &",650000,650000,0
R304120,"HAWTHORNE,N JAMES TR &","HAWTHORNE,N JAMES TR &",315000,315000,0
R107266,"KRAHN,CARL","KRAHN,CARL E &",138000,138000,0
R166112,"MALONE,MICHAEL J TR &",K & C CUSTOM HOMES LLC,250000,250000,0
R230298,"CROLL,STACEY C &","CUMMINS,CYNTHIA M",912500,912500,0
R220311,SKYLANE LLC,"PROCTOR,DARALYN R",81375,81375,0
R134735,"CLIFFORD,GRADY &","CLIFFORD,DOUGLAS R TR &",210000,210000,0
R228710,"REILLY,JIMMY J","REILLY,JASON",140000,140000,0
R224107,"SEAGRAVES,LEWIS &","SHONE,STEVEN &",330000,330000,0
R164505,"ATRE,TUSHAR",HIGHVIEW LLC,386000,386000,0
R216955,"NGUYEN,KYM","NGUYEN,KYM",120000,120000,0
R254426,"HIJ,VIOREL","MYERS,LOREN",95000,95000,0
R304731,"FIELDS,KATHRYNE","GILES,ELIZABETH B",950000,950000,0
R129405,CARTUS FINANCIAL CORPORATION,"BUHR,GREGORY P &",345000,345000,0
R212069,"BARISICH,DANIEL F-1/2 &",LAST MILE PROPERTIES LLC,318000,318000,0
R212069,"BARISICH,DANIEL F-1/2 &","BARISICH,DANIEL F-1/2 &",318000,318000,0
R304120,"HAWTHORNE,N JAMES TR &","HAWTHORNE,N JAMES TR &",315000,315000,0
R487030,CARTUS FINANCIAL CORP,BANK ONE TRUST CO TR,514900,514900,0
R216465,FRE 403 LLC,"DISBROW,CHARLES W II TR ET AL",1050000,1050000,0
R155494,"BRACKETT,GRANT","BRACKETT,DAVID",342000,342000,0
R225890,"MILLER,LARRY D &","COKLEY,CHARLES",177000,177000,0
R282632,"POLLOCK,DONALD E","POLLOCK,ELIZABETH G",380000,380000,0
R230356,"GRAHAM,DALE","GRAHAM,DALE M &",190000,190000,0
R212069,"BARISICH,DANIEL F-1/2 &","BARISICH,DANIEL F-1/2 &",318000,318000,0
R224976,"BAILEY,RICHARD J","BAILEY,KATHRYN M",172200,172200,0
R214447,"PRATT,JOHN P JR &","PRATT,JOHN P JR &",75000,75000,0
R121377,"BROWN,PHILIP F","BROWN,DAVID M &",375000,375000,0
R175005,NSHE POMPANO LLC,"PIGMAN,GARY &",210000,210000,0
R107438,"MORRILL,ALAN G &","MORRILL,MICHAEL B",297500,297500,0
R246687,SERAFORM ARCHIECTURE LLC,SERAFORM LLC,125000,125000,0
R111532,"AUGENBAUGH,ROBERT S",LITTLE RIVER LLC,300000,300000,0
R266363,"NGUYEN,TRI","LE,TU",127599,127599,0
R250614,"LE,TU","LE,ROBERT A",191000,191000,0
R158005,"JACOBSEN,PETE &","JACOBSEN,JESSICA C",207000,207000,0
R499139,"COBB,ZACHARY &","GRINSTEAD,JOHN W &",290000,290000,0
R532862,"BROWN,DAVID A &","NEWMAN,BARRY M",1000000,1000000,0
R156165,US BANK NATIONAL ASSN TR,"HAMILTON,JEFF D &",449900,449900,0
R284796,PRUDENTIAL RELOCATION INC,"KROHN,LARRY &",470000,470000,0
R339788,"DODSON,JOHN","DODSON,JONATHAN D",129900,129900,0
R215926,WILLAMETTE VALLEY PROPERTY,WILLAMETTE VALLEY PROPERTY,275000,275000,0
R339192,"KINCAID,RALPH D &","KOHLER,CLIFFORD L &",110000,110000,0
R308585,MARIPOSA AVE LLC,"MILBURN,JEREMY D",225000,225000,0
R306945,"HOPKINS,ROBERT B","ILLINGWORTH,JULIAN T &",315000,315000,0
R153007,"BLATTNER,CHRISTOPHER-50% &","BLATTNER,BRENT C-50% &",265000,265000,0
R304642,"KARMAZIN,KIRA","SINGER,DAVID M &",1400000,1400000,0
R247664,"STIFFLER,DANIEL F &","STIFFLER,JASON &",231000,231000,0
R589806,"INGRAM,GEORGE &","SLACK,JENNIFER",357900,357900,0
R208498,WEICHERT RELOCATION,"SLATTERY,KATHLEEN M TR &",834535,834535,0
R202664,"REILLY,JOHN K &","REILLY,JOHN K &",262500,262500,0
R207006,"DEAL,TIMOTHY","DEAL,TIMOTHY",214650,214650,0
R238519,"OLICH,EUGENE TR",Sale In Progress,305000,305000,0
R202664,"REILLY,JOHN K &","REILLY,JOHN K &",262500,262500,0
R225541,"LEBEDEV,ANDREY A","BEZZUBETS,IRINA V &",103500,103500,0
R220348,"HATT,BRIAN W &","HATT,NAOMI",255000,255000,0
R305758,"SPOONER,RALPH C","WARD,MELISSA J &",395000,395000,0
R532860,PRUDENTIAL RELOCATION INC,"HARATHI,KRISHNA &",760000,760000,0
R214447,"PRATT,JOHN P JR &","PRATT,JOHN P JR &",75000,75000,0
R136959,"LOCKE,VICTOR","POWERS,MICHELLE",110000,110000,0
R145154,"STEVENS,LINN C &","STEVENS,LINN C",135900,135900,0
R141712,"WILSON,JAMES D TR &","WILSON,JAMES D TR &",480000,480000,0
R147268,"JAKSICH,JERRY E TR &","JAKSICH,JENNY C &",685000,685000,0
R207006,"DEAL,TIMOTHY","DEAL,TIMOTHY",214650,214650,0
R193467,"HUANG,HONG","CHEN,SHOU-AN &",163000,163000,0
R216955,"NGUYEN,KYM","NGUYEN,KYM",120000,120000,0
R271811,FV-1 INC,"BELL,MARCIA A",62000,62000,0
R179057,"BROWN,EVELYN W",EVERETT CUSTOM HOMES INC,383000,383000,0
R590550,ADMIRAL PROPERTIES LLC,"GRASHER,ROBERT &",275000,275000,0
R283530,"LOCKHART,BRIAN K","LOCKHART,BRIAN K",171200,171200,0
R154351,CARTUS FINANCIAL CORPORATION,"ECONOMON,SUSAN",404000,404000,0
R187683,NATIONAL RESIDENTIAL,"LITT,ROBERT J &",480000,480000,0
R249429,"ROSE,LEE TR &","WICKA,NATHAN J &",340000,340000,0
R264678,"THOMPSON,MARVIN R &","BRAVO,ANTONIO &",135000,135000,0
R130435,"BERENSON,KEVIN &","LEWIS,MARY E TR",420000,420000,0
R309485,"HOCKMAN,RON &",THE RONALD O HOCKMAN & LINDA,383075,383075,0
R341740,"CREEDON,THEODORE &","STORLIE,ERIN &",534000,534000,0
R126185,"RUSSO,STEVEN &","THOMPSON,ERIN R &",655000,655000,0
R163791,"HALL,BILLY E","RYGG,ANDREW",140000,140000,0
R203430,"LANCEFIELD,JUDITH A &","LANCEFIELD,JUDITH A &",518000,518000,0
R136299,SIRVA RELOCATION LLC,"CERCEA,DUMITRU JR",225000,225000,0
R124003,"MILLER,M PETER &",PS MILLER PROPERTIES LLC,455000,455000,0
R145316,"PERO,ROBERT W-50% &","PERO,KYLE B &",265000,265000,0
R145316,"PERO,ROBERT W-50% &","PERO,KYLE B &",265000,265000,0
R134661,"APPLETON,MICHAEL S &","MOREN,JOHN L &",298900,298900,0
R146631,"LEONG,PAK","GOOD,HERBERT",96000,96000,0
R105995,"DUSTIN,CHARLES R &","DUSTIN,SETH I",240000,240000,0
R283275,"THANOS,JAMI J",ANTHONY RYAN LLC,296000,296000,0
R214023,"JONES,DANNY J",DK HOMES LLC,150000,150000,0
R233501,"TEKORIUS,DANIUS J &","TEKORIUS,DANIUS J",176000,176000,0
R494473,PRUDENTIAL RELOCATION INC,"POWELL,KELLI D",310000,310000,0
R263178,"DOWHANIUK,PAUL &","DOWHANIUK,PAUL &",325000,325000,0
R199215,"HUI,NAKITA A",Sale In Progress,134000,134000,0
R238336,"MONSON,MARY SUE-7/8 &","BAMBECHI,JAY",175000,175000,0
R278199,CITIMORTGAGE INC,"RIVELLI,KAREN P",74000,74000,0
R238336,"MONSON,MARY SUE-7/8 &","MONSON,MARY SUE-7/8 &",175000,175000,0
R271535,"PAYNE,CRAIG &","PAYNE,CRAIG &",94975,94975,0
R148326,COLUMBIA REDEVELOPMENT LLC,"DOCKTER,KATHLEEN L &",170000,170000,0
R197743,"FEIBEL,SADIE","FEIBEL,SADIE",8114,8114,0
R207718,"KOBATAKE,DARIN",MANOA LLC,133000,133000,0
R177319,RST GROUP INC,NEW DETAILED CO,134000,134000,0
R186222,"CASTLEMAN,NEAL &","CASTLEMAN,NEAL &",446900,446900,0
R114252,SKYLANE LLC,"PROCTOR,DARALYN R",200000,200000,0
R144654,"LEE,DUNG TRAN","CA,VU &",100000,100000,0
R186222,"CASTLEMAN,NEAL &","CASTLEMAN,NEAL &",446900,446900,0
R144654,"LEE,DUNG TRAN","CA,VU &",100000,100000,0
R138669,"CHANEY,JURI",WESTWOOD HOMES LLC,265000,265000,0
R271535,"PAYNE,CRAIG &","PAYNE,CRAIG &",94975,94975,0
R331987,"MCKEE,LYDIA E EST OF &","MCKEE,LYDIA E EST OF &",295000,295000,0
R340627,"SEIGEL,LEWIS",BRAMBILA PROPERTIES LLC,505000,505000,0
R285126,"MAMULA,GREG",WESTERN CASCADE TRADING &,265000,265000,0
R283871,"MARCY,FUMIKO TAKUSHI TR","MARCY,FUMIKO TAKUSHI TR",417500,417500,0
R216175,PRUDENTIAL RELOCATION INC,"HOHL,JIM &",248317,248317,0
R160370,CENTRAL OREGON POST &,"BLAGA,CHRISTIAN E &",275000,275000,0
R119204,"BOTHWELL,ROBERT","NICHOLSON,KIM M",165000,165000,0
R278606,"CALDWELL,GLORIA","SUMMERS,PATRICIA M",240000,240000,0
R292243,"SKIDMORE,KAYLA","SKIDMORE,JEFFREY TR &",280000,280000,0
R288748,"WITTEMYER,GEORGE","WITTEMYER,GEORGE-1/3 &",226500,226500,0
R296216,"TREADWELL,MICHAEL G &","TREADWELL,MICHAEL G &",320127,320127,0
R334143,"CHEUNG,SAMSON Y","NG,HUNG &",250000,250000,0
R211914,"GERLACH,JONATHAN L","GERLACH,JONATHAN L",418250,418250,0
R309094,GMAC GLOBAL RELOCATION,"WEIGANT,KASPER J",276000,276000,0
R224590,"PHAM,TRINH","LE,TU",127000,127000,0
R142700,"LEIPZIG,PAUL &","SILVERSTEIN,CAREY D &",327080,327080,0
R278012,THE ABLETON GROUP,THE ABELTON GROUP INC &,126000,126000,0
R165338,GRSW STEWART REAL ESTATE,"HUANG,WEI ZHI",599200,599200,0
R299196,HISTORIC HOMES RENOVATIONS LLC,"O'NEILL,SIMONE H &",689900,689900,0
R307115,PRIMACY CLOSING CORP,"GONZALES,LAWRENCE D",377800,377800,0
R155665,"ATRE,TUSHAR",HIGHVIEW LLC,416300,416300,0
R195918,"RAAD,SAMIR","RAAD,ALI M &",230000,230000,0
R110014,"BALK,PEGGY A","BALK,DAVID R &",644500,644500,0
R336349,"DO,VAN THANH","DO,JACKIE",159000,159000,0
R145802,"KOH,RAN HEE EST OF &","KOH,RAN HEE EST OF &",72000,72000,0
R146040,"STRAUB,KELLY N TR &","SPRING,AMANDA &",158000,158000,0
R145802,"KOH,RAN HEE EST OF &",APOSTOLIC FAITH MISSION OF,72000,72000,0
R145802,"KOH,RAN HEE EST OF &","KOH,RAN HEE EST OF &",72000,72000,0
R281369,EXACTURN INC,"OSETINSKY,ALLA",262000,262000,0
R142536,"LEMIRE,DAVID H TR &","LEMIRE,JEFFREY L",281500,281500,0
R137333,DEUTSCHE BANK NATIONAL,TTM CAPITAL FUNDING LLC,130000,130000,0
R278171,"THAN,PHUONG","VUONG,CHAU M &",125299,125000,-299
R191271,"COLE,KENNETH TR &","RANNEY,SARAH",260000,259600,-400
R162972,AAV ONE LLC,CRYSTAL VALLEY,215000,214600,-400
R216814,I & N CONSTRUCTION INC,"BENSON,JANET L &",70300,69900,-400
R132621,"ANDERSEN,DAVID &","HOOPER,LINDA",220000,219364,-636
R120702,STONE FINANCING LLC,"WILDER-MCCLURE,DYAN &",184500,183795,-705
R129928,DEUTSCHE BANK NATIONAL,"SHERRILL,KIRK",140000,139284,-716
R242095,"WHITSON,STEVEN M &","WHITSON,STEVEN M &",121000,120000,-1000
R301517,"CHIAVARINI,ROBERT L &","HAMILTON,WILLIAM D",240000,238950,-1050
R491402,"POOL,WILBERT L","HORTON,SUSAN JOY",181000,179900,-1100
R624829,"CHEN,QI PING &","KWONG,KWOK MING &",230000,228800,-1200
R137459,METRO HOMES NW ABA OF,N HODGE LLC,1200,0,-1200
R279056,"PUTNAM,WENDY","ESCOBAR,JOSE J &",314950,313500,-1450
R191371,GROUND BREAKERS CONSTRUCTION &,"STARTT,MICHELLE C &",267000,265000,-2000
R207560,"TORCATO,ANTHONY","WALZ,DAVID C",62000,59900,-2100
R304294,"JONSSON,ROBERT E","RICHMOND,JUDITH E TR",315000,312500,-2500
R165584,IMB REO LLC,"SUN,YUNLONG &",497900,495400,-2500
R602457,"MILLER,RYAN E","GUTIERREZ,MICHELLE",309000,306500,-2500
R536059,"LEGRY,MARY L","GONZALEZ,ANTONIO R &",287300,284721,-2579
R121571,"FRIE,DARYL L",HOMESALES INC,107000,104399,-2601
R307652,"HALL,BILLY E","RYGG,TIMOTHY S &",305000,302200,-2800
R198172,"BEZDIKIAN,VATCHE","LONG,JAMES W &",549900,547000,-2900
R245141,"ROBINSON,MICHAEL F","ROBINSON,AMANDA G",180000,176973,-3027
R108535,PCLT DEVELOPMENT LLC,PROUD GROUND,116820,113500,-3320
R124397,"WARREN,WILLIAM",WCW INC,190700,187210,-3490
R267485,OREGON PACIFIC DISTRICT,"WICKS,JIMMY E JR &",323500,320000,-3500
R224956,"YOST,DENNIS G TR","YOST,BLAKE T",103500,100000,-3500
R574984,HABITAT FOR HUMANITY,"ABIJURU,MARIE",128700,125000,-3700
R254716,"MITCHELL,DEAN T TR &","ROLL,WILLIAM H L TR &",284000,280275,-3725
R137800,PALUMBO CUSTOM HOMES LLC,"STEINHART,JOANNE M &",263900,260000,-3900
R205576,"LEE,DUNG T","MA,CANGSANG",196000,192000,-4000
R159810,"HEINLEIN,PATRICIA E","HEINLEIN,NICOLE D &",225000,221000,-4000
R221691,"HAMMERSCHMIDT,RICHARD E &","RASEY,CAROL E &",138000,134000,-4000
R140025,"CRAWFORD,DOMINIC G &","HORN,GENA M",165000,160500,-4500
R172441,"HOFFMAN,LINDA &",FEDERAL NATIONAL MORTGAGE,200000,195094,-4906
R539324,"TAYLOR,RYAN G","WALKER,TANYA",207500,202500,-5000
R111155,"ALLEN,STEPHEN",EARLYOIL THURMAN LLC,525000,520000,-5000
R270444,"WOLFSON,ALAN W &","ZEA-WOLFSON,TAMMAR J",225000,220000,-5000
R116851,"O'KEEFE,TERESA &","JOHNSON,WILLIAM D &",135000,130000,-5000
R176501,"HAWTHORN,BOB","ECKHART,KYLE M",300000,295000,-5000
R541230,"KING,JOHN &","SOLOMON,AMI",325000,320000,-5000
R209608,"HINKES,RICK","BURKHARDT,NEIL C &",250000,245000,-5000
R128511,"RHEE,TAE JUNG TR","MEGLI,ROBERT L &",735000,730000,-5000
R118200,"SNYDER,SUSAN","ZIMMERMAN,EVAN",280000,275000,-5000
R207033,"LIPSEY,MICHAELA M","LIPSEY,BENJAMIN S",300000,295000,-5000
R265799,"BAGLEY,NEDRA","RUCKMAN,CHRIS &",275000,269900,-5100
R160001,RP & ASSOCIATES LLC,"ROLFE,JACQUELYN &",205000,199900,-5100
R334335,"ALVAREZ,GILBERTO &","PUTNAM,WARREN R &",120500,115000,-5500
R539625,"JACOBBERGER,JOSEPH &","STAHL,DAVID J &",425000,419000,-6000
R193927,"TUNISON,STEVE",AAV ONE LLC,109500,103000,-6500
R217491,"KING,MICHELE","KASH,SHANE M &",190000,183000,-7000
R278628,"SCOFIELD,FRANCES J TR","OLNEY,WARREN B &",262000,255000,-7000
R207869,"DOBBINS,HEATHER-1/2 &","THORNDIKE,MARK J &",315000,307500,-7500
R233128,"WALSTATTER,MICHAEL R TR &","RAY,SUSAN C TR",457755,449900,-7855
R155691,"DEVAN,MUKUND RAJ","LALLI,MARIA D",343000,335000,-8000
R245878,"FIGUEIRA,ANNA M","CHASSE,LOREN &",278000,269615,-8385
R208696,"COPP,SHERRY L &","MILLER,MICHAEL",296000,287500,-8500
R171104,"REES,AMBER E","VOEKS,JIN &",335000,326500,-8500
R117586,"KELIHER,KATHLEEN P","MCCARTY,KAREN",550000,541500,-8500
R130912,"REGAN,PATRICK &","CEREGHINO,JOSHUA &",513500,505000,-8500
R242458,RP & ASSOCIATES LLC,"POITRA,JODI H",253000,244500,-8500
R120211,"FASANO,WILLIAM P",HSBC BANK USA NA TR,160000,151056,-8944
R101914,"HUNTINGTON,CYNTHIA &","ZITO,ANTHONY F",316000,307000,-9000
R598543,"GOODSON,SARAH E","SWEAZEY,JAROM M &",260950,251500,-9450
R222011,"CARPENTER,WILLIAM T &","RUDOWSKY,TIMOTHY S ET AL",348525,339000,-9525
R145515,PCLT DEVELOPMENT LLC,PROUD GROUND,175230,165500,-9730
R164885,"LEACH,BENJAMIN &","JOHNSON,ERIC A &",295000,285000,-10000
R326407,"MARSHALL,JOHN R &","TOUTONGHI,PAULS H &",530000,520000,-10000
R216358,"NESBITT,RHODENE A","ALEKSIC,NEBOJSA",375000,365000,-10000
R302356,"JONES,DAN J","ELSON,BEVERLY",285000,275000,-10000
R145602,"TAYLOR,ALICE M","RUNION,PHILLIP &",190000,180000,-10000
R154114,"SWAFFORD,C MATT","FOX,JAMES F &",460000,450000,-10000
R157881,SCHUMACHER CUSTOM HOMES INC,"WESTERLUND,KAREN E",160000,150000,-10000
R111942,"HOELTING,ROBERT","EXERJIAN,HENRY",220000,210000,-10000
R250820,"SMITH,MICHAEL R","HUANG,CHRISTOPHER F",175000,165000,-10000
R305486,"ALVAREZ,STACEY","DOMINGUEZ,ANDRES",235000,224900,-10100
R183169,PCLT DEVELOPMENT LLC,PROUD GROUND,128700,118500,-10200
R112881,"ROOT,DANIEL J &","BULLOCH,SCOTT W &",477000,466500,-10500
R293562,"GILBERT,DENNIS L &","MORGAN,O RAY TR",204000,193500,-10500
R158178,"DOWDEN,PEGGY","DENMAN,JONATHAN M",196191,185500,-10691
R326714,PORTLAND DEVELOPMENT GROUP,"VORHEES,STEVEN C &",549900,539000,-10900
R605970,"NIKOLAISEN,JEFFREY &","WEISMAN,JORDAN G &",358000,347000,-11000
R297107,"CARLOZZI,JONATHAN M &","VAN BUREN,JOSEPH J &",453000,442000,-11000
R121560,TYLER DURDEN LLC,"TERRYAH,JAIME R",136000,124900,-11100
R297211,FISH CONSTRUCTION NW INC,"CULLIGAN,JOSEPH A &",245000,233500,-11500
R116188,"BRENNFLECK,GEORGE A TR &","PIZZUTO,TERRY &",224000,212000,-12000
R200989,"RENNE,RICHARD N &","GOBLE,GLADYS L &",330000,318000,-12000
R533003,"HENDERSON,BRANDON S","JENNINGS,RODNEY D &",300000,287950,-12050
R297647,PCLT DEVELOPMENT LLC,PROUD GROUND,173250,161000,-12250
R268022,"GILBERT,SHANNON","WENTWORTH,ANN MARIE",276000,263500,-12500
R144586,"KRUSE,NOREEN M","DUFRENE,JEAN L A",272500,260000,-12500
R264169,URBAN HOUSING DEVELOPMENT LLC,"COLEMAN,CHET A",102500,90000,-12500
R265109,"WINDSHEIMER,MYRON D &","BAKKEN,DEAN A &",199900,186997,-12903
R208106,"SEHORN,WILLIAM L SR TR &","SEHORN,BRUCE",182500,169526,-12974
R102486,"DALEY,JOHN R","SEYDA,LAUREN &",307000,294000,-13000
R164488,"JARNAGAN,TIMOTHY S TR &","COOPER,MATTHEW &",246000,233000,-13000
R117797,"NEUMANN,ERIC P &","MEYER,DONNA R &",475000,461500,-13500
R273515,"SAVARIN,EVELYN TR",TTM DEVELOPMENT COMPANY,339000,325000,-14000
R215931,"DE FRIEZ,PAULINE","GUTTAG,BEVERLY",351000,336950,-14050
R509093,"STUART,ROBERT D","FERNANDEZ,LUIS J &",414400,400000,-14400
R279942,"YARBROUGH,SLAYDEN A &","PALMER,JOSH",220000,205500,-14500
R116486,"JOYNT,RYAN",DEUTSCHE BANK NATIONAL,220000,205297,-14703
R130318,"JORDAN,JUDITH S","HAMMAN,ELAINE",182900,168000,-14900
R309279,"COLE,ELIZABETH","HALE,MICHAEL &",324900,310000,-14900
R241856,RP & ASSOCIATES LLC,"LOREN,DANIEL S",250000,235000,-15000
R494473,"POWELL,KELLI D","CAVANAUGH,JEAN A",310000,295000,-15000
R219677,"RUOFF,KENNETH J &","RUOFF,STEPHEN A",415000,400000,-15000
R198312,"CARSON,JESS &","SUMAROKOV,VLADISLAV &",565000,550000,-15000
R270358,"MC KINLEY,DAVID &","THIELEMANN,PAUL",205000,189950,-15050
R195999,RP & ASSOCIATES LLC,"HUA,CORY &",115000,99900,-15100
R247901,EDEN ENTERPRISES LLC,"BOYD,STAFFORD D &",375000,359900,-15100
R275608,"HEIFETZ,ISAAC &","MCRAE,KENNETH J",196000,180000,-16000
R228970,"HUBACK,PATRICIA","ACASTER,MARTIN",250200,233900,-16300
R115117,"ALLEN,ANGELA","TOMKINS,BENJAMIN TR &",296300,280000,-16300
R289785,M&T; BANK,HW HOLDINGS LLC,137880,121500,-16380
R285208,"BENNETT,CHRISTINA","WHITEHEAD,DONALD M &",716625,699900,-16725
R125347,"KREGER,JOHN A &","VAZQUEZ-ANGUIANO,GUSTAVO",200000,183000,-17000
R110167,"WEST,BRANDON",FEDERAL NATIONAL MORTGAGE,181000,163762,-17238
R158124,"MOORE,LEROY G","PECHETTE,TYLER J &",242500,225000,-17500
R330172,CENTRAL CITY HOMES LLC,"RUMSEY,ROBERT K &",249900,232000,-17900
R161975,"HALE,CLARK C","YORK,JENNIFER M &",262000,244000,-18000
R197141,"IRAHA,CHOJUN &","NYARY,BONDI",110000,92000,-18000
R245600,NSI INVESTMENTS LLC,"KOCH,ROBERT W",71000,52500,-18500
R201680,"GLAESER,MARTIN","JOHNSON,LAURA &",329000,310000,-19000
R150620,"FLINT-SOMERVILLE,BRYCE &","AMBERSON,MEGAN R &",394000,375000,-19000
R263548,WES MOORE LLC,"RICHARDS,CHARLES",198000,179000,-19000
R239845,"SWEZEY,SUSAN L","SWEZEY,SHARON",344000,325000,-19000
R119204,"BOTHWELL,ROBERT","BRYANT,JAMES",165000,145500,-19500
R556931,"MCKELLAR,DAVE","PRODOEHL,BENJAMIN J &",189900,170000,-19900
R172135,RP & ASSOCIATES CONSTRUCTION,"JOERGER,BLAKE J",189900,170000,-19900
R278754,"MIZOTE,TAKA","LA DOE,BONITA",255000,235000,-20000
R132225,"BYRD,MERRY C TR","MAYHEW,RUSSELL J &",294000,274000,-20000
R209836,"HOPKINS,CAROL","GIBSON,NATHANIEL &",280000,260000,-20000
R326812,"JUNKER,ALLAN &","COALMAN,MARJORIE",420000,400000,-20000
R263535,"BURNS,MELANIE","LE,DENNY VAN &",170000,150000,-20000
R245212,"GNICH,JASON D &","AUSTIN,NATHAN O",245000,225000,-20000
R118376,"SETTLEMIER,GLORIA D","BARBEE,SAUL",258000,237000,-21000
R303007,DEUTSCHE BANK NATIONAL,"POWERS,JASON &",271000,250000,-21000
R161327,"WHITEMAN,FRANK H &","BLUBAUM,BRIAN T",275000,253000,-22000
R204998,BENNETT FAMILY LLC,"BENNETT,MONICA M &",202000,180000,-22000
R276795,"YOUNG,NANCY L","KARLIK,DEANNA M",152000,130000,-22000
R181281,EDEN ENTERPRISES LLC,"LOUISELL,THOMAS H &",368500,346000,-22500
R235313,"NEDELISKY,JAMES &","SCHNELL,GARY &",235000,212000,-23000
R241532,RP & ASSOCIATES LLC,"BEUKELMAN,BREANNA A &",267000,243900,-23100
R294075,"HOYT,BRUCE M &","WATERS,NEIL L &",331150,307729,-23421
R264593,"MARTENS,WILLIAM A &","LOVATO,DOMINIC &",288500,265000,-23500
R112876,"DYLAN,PHOEBE","CIOCHETTI,DAVID &",672000,648475,-23525
R267558,"KRAMER,CANDACE &","RINALDI,JOANNA M &",326625,303000,-23625
R283530,"LOCKHART,BRIAN K",WRIGHT VENTURES LLC,171200,147500,-23700
R140178,METRO HOME NORTHWEST,"MORELL,RYAN D",99000,75000,-24000
R307060,WILSHIRE TERRACE LLC,"COGAN,SARA",250500,226500,-24000
R271282,"HOPP,ANDREW E","WEAVER,PAUL D",399745,375000,-24745
R563962,"GEBHARDT,GARY A &","MARK,JUSTIN",374900,350000,-24900
R144710,"MCFOLLING,CARMINA R &","QUILTY,SUSAN M &",149900,125000,-24900
R116915,"MCKAY,DEAN E TR","ABEBE,FASIL B &",200000,175000,-25000
R285592,"MC DANIEL,ALISHA M &",LASALLE BANK NA TR,182500,157452,-25048
R312104,"AGUIRRE,LUCIA",FOX CAPITAL CORPORATION,212000,186728,-25272
R282784,RP & ASSOCIATES LLC,"MARSHALL,VICTORIA K &",251000,225000,-26000
R338033,"KARAM,FARES","KARAM,FARES-50% &",53000,26500,-26500
R304917,"WORTHEY,WILLIAM &","WORTHEY,WILLIAM &",190000,163036,-26964
R291381,"PETERSEN,JOHN I TR &","YOUEL,CHARLES D &",207000,180000,-27000
R185771,"FERRIS,AMBER N &","HAYS,TRENT M",307000,279000,-28000
R163053,SUN CREST CONSTRUCTION INC,"FOX-NYSTROM,JESSICA N",207000,179000,-28000
R575210,"SIAK,NADINE L","SAYRES,PHILIP C JR &",252000,224000,-28000
R205280,RP & ASSOCIATES LLC,"MILLER,COLLEEN L &",250000,221000,-29000
R291972,"CLEMMENS,DENNIS R &","CLEMMENS,BRANDON D",165000,136000,-29000
R148245,"OLSON,SCOTT","BAKER,STEVEN C &",277000,248000,-29000
R176708,"KIEDAISCH,SAGE T &","WISHNIE,JEFFREY L",509000,480000,-29000
R197826,"TINNEY,WILLIAM F","DICHARI,SAADDEDINE",179000,149900,-29100
R193726,"COSS,RICHARD A &","CRAWFORD,WILLIAM &",322000,292500,-29500
R134314,"KEANE,GORDON &","KEANE,MERRIL A",349900,320000,-29900
R193929,METRO HOMES NORTHWEST LLC,"MCGUIRE,CASEY &",354900,325000,-29900
R264867,"MEYERS,GREGORY J &","BOYD,MARVIN R &",240000,210000,-30000
R260783,"BARKER,SANDRA &",DILUSSO HOMES LLC-2/3 &,930000,900000,-30000
R260783,"BARKER,SANDRA &",DILUSSO HOMES LLC-2/3 &,930000,900000,-30000
R268913,"MULLIN,DEAN M","YOUNG,ANDREW A &",500000,470000,-30000
R213033,"KIMBALL,ANNE L","TUTSCH,KARL F",280000,249950,-30050
R212600,"BONADUCE,JULIE",FEDERAL HOME LOAN,249950,219033,-30917
R234435,"RUESS,ANDREW &","RUESS,ANDREW",141000,110000,-31000
R312191,"O'REILLY,DANIEL V &","LOMBARDOZZI,KIRA",236000,205000,-31000
R233247,METRO HOMES NORTHWEST LLC,"FARR,JOSHUA N &",300000,269000,-31000
R279048,"BEATEY,ROBERT W &","CRUMP,ROBERT L &",397500,366330,-31170
R282447,"CHILDS,DONNA L","NACINOVICH,WADE &",345000,313400,-31600
R275639,"COPLEY,CHRISTY","STOUT,THOMAS A",77000,45000,-32000
R493544,"CHIPMAN,ANDREW &",WELLS FARGO BANK NA TR,189500,157429,-32071
R542132,"SHARP,ALAN L","BARNES,SCOTT L",139900,107000,-32900
R173295,"REED,CAMERON D &","RHOADS,MICHELLE",368000,335000,-33000
R159995,EVERETT CUSTOM HOMES INC,"MERCHANT,NEIL M",210000,177000,-33000
R190116,EDEN ENTERPRISES LLC,"POWELL,THOMAS A",423311,389900,-33411
R319829,"NISHIMURA,TAKU","OKUMURA,KRISTIN T",220000,186298,-33702
R218850,"WARHUS,DAMON A &","HERNANDEZ,MICHAEL",746000,712000,-34000
R279784,"GIRARD,JENNIFER","VANCE,PAUL W &",384900,350000,-34900
R138079,"JURRENS,R DAMION &","WIETECKI,MICHAEL J &",660000,625000,-35000
R168015,"PARK,CHAN &","O'NEIL,JOHN H",138000,103000,-35000
R248793,EDEN ENTERPRISES LLC,T&A; INTERNATIONAL LLC,175000,140000,-35000
R250215,"CALLAHAN,CHRISTINE B","CLAUDIO,JESUS",95000,60000,-35000
R271341,ACCENT RESIDENTIAL HOMES INC,ACCENT UPPER DRIVE HOLDINGS LLC,375000,340000,-35000
R334294,"ANDERSON,CHRIS & LORI &","SCHMIDT,SHANNON L &",220000,184960,-35040
R296308,"NABHAN,MARC A &",FEDERAL NATIONAL MORTGAGE,249900,214810,-35090
R208434,"KOWITZ,MYLIAM Y &","SHEEDERS,ANGELINA M ET AL",210000,174600,-35400
R179062,"HOOPER,MARY E","KASHIWAGI,TAKEO &",325000,289500,-35500
R242315,WELLS FARGO BANK,"NASH,SCOTT F",146054,110000,-36054
R112584,"KING,ROBERT G &","REESE,ADAM &",504000,467500,-36500
R213342,"BLOMBERG,JOHN T","NGUYEN,TRUONG MANH",212000,175000,-37000
R533736,"SKJEI,JEANNETTE",RUIYEE LLC,165000,128000,-37000
R149572,"SAMPSON,KATHERINE J","BREYER,SAMUEL B &",487500,450000,-37500
R149572,"SAMPSON,KATHERINE J","BREYER,SAMUEL G &",487500,450000,-37500
R242049,"BENNINGTON,JONATHAN L &","NYE,CHRISTOPHER M &",300000,262500,-37500
R164483,"GLENN,MICHAEL &",SUNTRUST MORTGAGE INC,361000,323403,-37597
R249866,"ADAMS,KELLEY J","NGUYEN,PHONG HUYNH &",212500,174900,-37600
R591045,"CHONG,SUNNY N",FEDERAL NATIONAL MORTGAGE,215000,177218,-37782
R209772,"DORITY,THOMAS E","LAASCH,FRANCIS E",178000,140000,-38000
R120782,"PECKENS,BRIAN T &","COOLEY,JEFFREY",157000,119000,-38000
R291789,METRO HOMES NORTHWEST LLC,"LIBERATOR,TERESA M",345000,306000,-39000
R118222,COLUMBIA REDEVELOPMENT LLC,"HOBSON,KELLI L",400000,360900,-39100
R266567,"BALMUTH,MICHAEL TR &","SHELFORD,DONALD",529000,489900,-39100
R161252,"BREWSTER,NANCY","METSGER,KAY E TR",324500,285000,-39500
R251524,"ANDERSON,DUSTIN D &",FEDERAL HOME LOAN,183500,143936,-39564
R575410,"MATOTT,JANET R","SCOTT,MARGARET L &",469900,430000,-39900
R278760,"LEE,DAVID T &","LOGAN,NORMAN D TR &",340000,300000,-40000
R285223,"CARROLL,MICHAEL N","KALUF,SAMIR",605000,565000,-40000
R205906,"UNKEFER,M LINDA LEE","VALLEJOS,CRISTIAN &",385000,345000,-40000
R260759,"NIELSEN,SANDRA K TR","WRIGHT,SETH O &",469000,429000,-40000
R196231,"FORZLEY,KRISTINA T","PARISI,SANDRA N",299000,259000,-40000
R147204,"SNOW,KATHERINE M TR &","BILODEAU,TIFFANY C",470000,429900,-40100
R234725,US BANK NATIONAL ASSN TR,HAMPTON PLACE LLC,174380,134000,-40380
R329987,"HO,MARY J","ADELMAN,ALICE",363300,322450,-40850
R283930,"BURMAN,KATHLEEN &","JAFFE,STEVEN M &",600000,559000,-41000
R252617,"KRANZ,AUDREY","HUDSON,JASON",228145,186430,-41715
R574871,"LEI,YU-YING-77% &","LEI,TING-KWO &",167500,125510,-41990
R218616,"RUESS,THOMAS &","RUESS,NICHOLAS",152000,110000,-42000
R160458,SIDERAS CONSTRUCTION,"GIBSON,ELIZABETH C",279900,237500,-42400
R108804,"SILBERMAN,VERONICA &","CHAN,RONALD Y &",729000,686580,-42420
R307377,"PLASS,SUE A","WOZNIAK,JULIAN J &",317500,275000,-42500
R288259,"LUCAS,CHARLESETTA","YASIN,SHADE",250000,207500,-42500
R178853,"CLOSE,ROBERT A-33 1/3% &","CLOSE,ROBERT A-50% &",283000,240000,-43000
R219233,"BLISS,CHARLOTTE","ROTONDI,FRANK P",338500,295000,-43500
R245356,"SHADEL,BOBBI J &","DEAN,BROOKS &",269900,226000,-43900
R339451,CORPORATION OF THE PRESIDING,TWSOMMER HOLDINGS LLC,524800,480000,-44800
R217083,"GREENROYD,DUSTIN",OCEAN EQUITY GROUP LLC &,98000,53000,-45000
R119869,"DEVRIES,DOUG-1/3 &","FRANK,KATHERINE S &",207000,162000,-45000
R147700,"COONRAD,ROBERT M &","KERN,MARY E",210000,165000,-45000
R250483,"LEININGER,JESSE L &","VANDERMEER,JAN K &",195000,150000,-45000
R559834,"EAGER,DAVID &","AMADON,WILLIAM H",755000,710000,-45000
R599426,"CURREN,JEFFREY S &",PENSCO TRUST COMPANY CUST,412000,367000,-45000
R278964,"COGBURN,BILLIE A","RUEBER,RICHARD W",224950,179500,-45450
R523066,"ROUW,DANNILEE",OVERLOOK HOLDINGS LLC &,207000,161500,-45500
R226790,"ADAMS,DENNIS &","ADAMS,DENNIS &",45833,0,-45833
R166339,"BATTAN,DEVIKA","BATTAN,DEVIKA",45877,0,-45877
R299254,"LILKER,STEVEN","PATTON,CAITLIN E",350000,304000,-46000
R229289,"BEALL,JOAN R","SCOTT,CARLA",349000,303000,-46000
R138013,"KELLER,ANNE","BODEMAN,NICK &",289500,243000,-46500
R124275,"CHOU,PHILIP T &","EGE,ROSS L &",80000,33000,-47000
R318980,"BAHRU,KIBATU K &","NGUYEN,LINH B",255000,208000,-47000
R163613,RP & ASSOCIATES LLC,"TURNER,JEANNE M",294700,247620,-47080
R163613,RP & ASSOCIATES LLC,Sale In Progress,294700,247620,-47080
R234149,"BENEDICT,YAMUNA",FEDERAL HOME LOAN,341500,294350,-47150
R299173,LINCOLN TRUST COMPANY,"TIEDER,MICHELLE R",380000,332650,-47350
R197146,"KASSEBAUM,RICHARD","MACCALLUM,MITZI K",157500,109900,-47600
R307314,RP & ASSOCIATES LLC,"FIEHN,PAMELA A &",387500,339900,-47600
R120490,"BERNHARDT,NATHAN","CLEMENS,TED",70000,21000,-49000
R181118,METRO HOMES NORTHWEST LLC,"KLIMT,CARL A &",255000,206000,-49000
R606825,"STERLING,SERENA","AHMED,HAMDI &",449000,399750,-49250
R575433,"GARDNER,JANICE TR","SAFIRSTEIN,JOSEPH J &",1399900,1350000,-49900
R163615,RESCOM CAPITAL LLC,"HELZER,RICHARD J &",299900,250000,-49900
R284415,"ERLANDSON,DARRYL",FEDERAL NATIONAL MORTGAGE,290000,240027,-49973
R219148,"BARRON,GREGORY &","BEELER,KARL J &",285000,235000,-50000
R254836,"BECHTEL,JAMES L JR &",FEDERAL HOME LOAN,291000,241000,-50000
R540025,"ISPIR,DUMITRU &","MANNING,RANDY P",350000,300000,-50000
R281198,"AMAN,WALTER B &","SCAVARDA,AMY E",325000,275000,-50000
R270285,"BLANCHARD,DEBORAH A","ZUMWALT,WILLIAM &",340000,290000,-50000
R306486,RENAISSANCE CUSTOM HOMES LLC,"REED,CHRISTOPHER W &",340000,290000,-50000
R173577,"DALY,MARK W","JERKO,CHRISTINE A &",450000,399900,-50100
R120645,LITTLE HAT CAPITAL LLC,MHT ASSETS LLC,51000,0,-51000
R108579,"LIN,AMY","LI,HONGBO &",93199,41841,-51358
R121562,FOX CAPITAL CORP,OC REALTY LLC,52000,0,-52000
R291014,"SWIECICK,RANDINE S &","SWIECICK,KATELYN R",244500,192287,-52213
R276762,"ELLYSON,DEBORAH","LEBLANC,CHRISTINA B",204500,152000,-52500
R224688,"LANCASTER,LORREN &","HUBBARD,STACY",185000,132500,-52500
R165268,"OTA,MASATO &","JOU,JANICE &",718000,665000,-53000
R599039,"BENNION,MARK &","MANN,GARETH E",227900,174900,-53000
R155915,"COOKE,DEIDRE","KAFFEN,AARON I &",333000,280000,-53000
R573632,"PETERSON,PAMELA D","RUANO,ERICK GIOVANNI C",245395,192000,-53395
R117106,"TRAN,STEVEN",US BANK NATIONAL ASSN TR,242000,188088,-53912
R135221,"HENRY,RICHARD &","DAY,GARY A",230000,176000,-54000
R110997,"HAY,HAROLD L","TRACEY,MARK R",320000,266000,-54000
R126924,"ACHTER,E ADAM","RANDLES,JOHN &",349000,295000,-54000
R240300,"SIRPLESS,SARAH M","REID,BRUCE K",176000,121500,-54500
R228844,"COVERT,JENNIFER &","KEELING,ANDREW",55000,0,-55000
R125013,WEST RIVER LLC,"PIMLEY,JACOB M",55000,0,-55000
R205610,"BRANDES,DAVID","PAGE,BARBARA",320000,265000,-55000
R201322,"MARTINEZ,GERARDO","MARTINEZ,MARIA F",55000,0,-55000
R190415,PDX RENOVATIONS LLC,"SIENKIEWICZ,ANTHONY &",430000,375000,-55000
R124130,"GRADY,FRANK D &","GREGOIRE,MARC R &",444930,389500,-55430
R153359,EDEN ENTERPRISES LLC,INTRINSIC HOMES LLC,274000,218500,-55500
R111893,"JONES,RANDOL C",FANNIE MAE,401500,345837,-55663
R319722,"BERNHARDT,NATHAN","BERNHARDT,NATHAN &",125900,70000,-55900
R329375,"HUBBARD,JEFFREY B",CITIBANK NA TR,360000,303303,-56697
R204910,"BRANIGAN,WILLIAM A &","BRANIGAN,BRIAN C &",206775,150000,-56775
R606030,RP & ASSOCIATES LLC,"MCMURDIE,JAKE",306100,249000,-57100
R142444,"JANKE,MICHELLE &","ALLEN,DENNIS M",590000,532500,-57500
R214312,"LE,NAM VAN &","LE,THI HOA",237500,180000,-57500
R573144,"SKINNER,STEPHEN D &","RASHEED,HASSAN H &",445000,387000,-58000
R213972,"LEA,ROBIN C TR","MAIANO,MERRILL A &",519000,460000,-59000
R312282,"D'UVA,ARLENE &",WEICHERT RELOCATION,319000,260000,-59000
R125426,"RITCHHART,BARBARA L","GRABSKI,DANIEL E",219900,160500,-59400
R216955,"NGUYEN,KYM","NGUYEN,KYM &",120000,60000,-60000
R180732,"TORKAMAN,AFSANEH R","HANSON,KARYN G &",223000,163000,-60000
R240984,"WU,SINT FOOF &","LIU,NUI KEM",160000,100000,-60000
R321582,"SHARYAN,MERUZHAN","SHARYAN,ANUSH",60000,0,-60000
R280340,"CAPOBIANCO,DONATO C &","HIRSHON,JASON &",675000,615000,-60000
R106906,"JONES,DAN &","ELSON,BEVERLY",360000,300000,-60000
R175298,"UNIS,DARCY L &","UNIS,TAYLOR M &",235000,175000,-60000
R261486,"PRICKETT,SETH N",4547 LLC,60000,0,-60000
R228884,"JONES,KATHLEEN F","PENCE,MELODY L",210000,150000,-60000
R216955,"NGUYEN,KYM","NGUYEN,KYM &",120000,60000,-60000
R334766,"TRAN,VU","TRAN,VU-20% &",60050,0,-60050
R269886,"CLIFTON,ELISE L","MACLAREN,MICHAEL T &",238000,177900,-60100
R265970,"FLEISCHER,DANIEL &","RIST,AMY JO",272000,211154,-60846
R262098,"WARNCKE,MICHAEL","EGGIMANN,SCOTT A",226000,165000,-61000
R229543,"GARZ,FLOARE",CENTRAL MORTGAGE COMPANY,153600,92500,-61100
R336443,"TRAN,ANGIE UYEN &","HUYNH,THINH H",62000,0,-62000
R269931,"YOUNG,FRED J &","WILSON,PATRICIA K",232000,170000,-62000
R271811,"BELL,MARCIA A","BELL,MARCIA A TR &",62000,0,-62000
R195612,JT & LS HOLDINGS LLC,"DEL VILLAR,JENNIFER E",300501,238500,-62001
R298633,"LANNING,MICHAEL F","DAVIDSON,KIMBERLEY A",259000,195000,-64000
R309209,"JOHNSTON,WILLIAM R &","MOORE,JACK A &",330000,266000,-64000
R286278,"MENTZE,RICHARD &","MENTZE,RICHARD",85000,21000,-64000
R232745,"DEMPEWOLF,MARK J &","ROBINSON,JEFFREY D &",430000,365000,-65000
R110700,"SKORO,ANTE",SKORO BROS HOMES LLC,65000,0,-65000
R334405,A REAL GOOD SOLUTION LLC,CREATING HAPPINESS LLC,65000,0,-65000
R271815,"BELL,MARCIA","BELL,MARCIA A TR &",65000,0,-65000
R335646,"BUI,LONG &","BUI,LONG ET AL",65000,0,-65000
R221523,"GRAY,MELISSA","EISENZIMMER,MARK",230000,165000,-65000
R223404,"DO,DAVID HIEP","DO,MICHAEL",66100,0,-66100
R481670,"TORO,RAUL","TORO,RAUL &",67050,0,-67050
R176364,STAI ENTERPRISES INC,"D'AMBOISE,MATTHEW J",407600,340000,-67600
R558216,"EPHREM,JOSHUA L","BURKLUND,DUSTIN D &",250000,182000,-68000
R108107,"UNDERDAHL,REES &",MAPLELEAF PROPERTIES LLC,68000,0,-68000
R247207,"MATSEN,LAURA J","LIGHTNER,JONATHAN E",343000,275000,-68000
R208713,"WINGERTER,SHIRLEY","NASH,CHEVY",242000,173250,-68750
R108950,"AEDER,RICHARD M","AEDER,RICHARD TR &",69000,0,-69000
R293951,"SADO,NEGUSSIE",APEX ENTERPRISE TEAM LLC,70000,0,-70000
R293951,"SADO,NEGUSSIE",Sale In Progress,70000,0,-70000
R317775,"KNIGHT,NOELLE J","WELLS,MARC L &",455000,385000,-70000
R290312,"LIAN,YI YVONNE","LEONG,PAK",70000,0,-70000
R574377,"REYNAGA,ANICETO","REYNAGA,EDUARDO",70000,0,-70000
R205938,BUILDING BLOCKS LLC,"NGUYEN-JOHNSON,JEANNETTE T",350000,280000,-70000
R135446,"LI,HONGBO &","LEONG,PAK",70000,0,-70000
R203415,PENSCO TRUST COMPANY CSTDN,"RICE,JAMES S &",385000,315000,-70000
R338358,AAV ONE LLC,AAV TWO LLC,70000,0,-70000
R120460,WHITE RIVER REDEVELOPMENT LLC,SNYDER CONSTRUCTION LLC,70000,0,-70000
R104328,"FENSTERMACHER,JESSICA &","HAHAJ,BRANDON J &",70100,0,-70100
R118639,"HOFFMANN,MICHAEL G &",FEDERAL NATIONAL MORTGAGE,389000,318899,-70101
R293928,"DO,MICHAEL &","DO,MICHAEL",70500,0,-70500
R293928,"DO,MICHAEL &",Sale In Progress,70500,0,-70500
R118319,RIDGEWAY PROPERTIES LLC,RIDGEWAY PROPERTIES &,71000,0,-71000
R143953,"DOMINGUEZ,GUADALUPE",THE BANK OF NEW YORK MELLON TR,167400,96300,-71100
R268665,"FENTON,SHERRIE &","FENTON,SHERRIE &",71140,0,-71140
R237631,"MAY,ROBERT J &","LETTIERE,MARK",427000,355000,-72000
R276350,"GIBSON,RAYMOND E &","GIBSON,SHELLIE",72000,0,-72000
R183456,"LEMLEY,CRAIG &","TANG,TERESA",657000,584606,-72394
R639092,"HUANG,FENG MEI","ZHEN,XIN YU &",173000,100000,-73000
R300327,STOTT CIRCLE LLC,"CASHATT,KEVIN",73500,0,-73500
R242777,"ARNTSON,NECHELE L","WILSON,DEAN &",348680,275000,-73680
R481419,"GOOD,HERBERT",VISTA RENOVATIONS LLC,74000,0,-74000
R122884,"MATRISCIANO,JOHN",JOHN D MATRISCIANO M D INC,74550,0,-74550
R166606,"MORRISON,SAMUEL J","MORRISON,SAMUEL J TR",75000,0,-75000
R161893,"SHERVEY,FREDERICK","CRAIG,ALLAN R",250000,175000,-75000
R140216,"ORCUTT,JAMES &","ORCUTT,JAMES",75000,0,-75000
R252981,"BRIECE,JOHN A",JAB PROPERTIES,75000,0,-75000
R159182,"PEREZ-PEREZ,JORGE O","GONZALEZ-PONCE,LILIA E &",75000,0,-75000
R250878,"DALSEMER,TERRY A &","JOHNSON,KARL &",390000,315000,-75000
R225825,"REED,DOUGLAS K","REED,DOUGLAS K",75000,0,-75000
R104727,RDKN PROPERTIES LLC,"SZIGETHY,STEVEN L &",317400,242000,-75400
R547600,"BARNES,JASON L","MCCARTY,CAMERON",220000,143376,-76624
R183524,"JOHNSON,LORI JEAN","GRAY,PATRICIA",210000,133000,-77000
R261922,"BAUMGARDNER,GREGORY &","PENN-YOUNG,SHEILA D",77000,0,-77000
R155565,EDEN ENTERPRISES LLC,RENAISSANCE CUSTOM HOMES LLC,342000,265000,-77000
R335182,AMRA HOMES LLC,BUSINESS BANK,145000,68000,-77000
R161087,"BAUGHER,BRETT M &","TON,TONNY",332500,255000,-77500
R261494,"AKROUSH,RADWAN &",AKROUSH HOMES LLC,78000,0,-78000
R317620,CASH FLOW INVESTMENTS LLC,42ND AVE LLC,78000,0,-78000
R317620,CASH FLOW INVESTMENTS LLC,Sale In Progress,78000,0,-78000
R238350,"CAO,CANH","CAO,THUY",78000,0,-78000
R266014,"YANG,LIMEI",WBC INVESTMENTS LLC,78000,0,-78000
R103934,"OCHS,JON A &","OCHS,NATASHA &",79000,0,-79000
R217112,"TODD,JOHN L",Sale In Progress,80000,0,-80000
R230913,"FIELDER,JAMES","FIELDER,JAMES &",80000,0,-80000
R185861,EVERETT CUSTOM HOMES INC,INTRINSIC HOMES LLC,295000,215000,-80000
R163011,100 ACRE PROPERTY LLC &,"CHAN,KARL",90000,10000,-80000
R167671,"ROMANOV,DANIIL","ROMANOV,DANIIL &",80000,0,-80000
R336005,"HOFFMAN,WAYNE","HOFFMAN,JULIA",355000,275000,-80000
R159104,"KARIN,DAMIR",DK HOMES LLC,80000,0,-80000
R135440,"LEONG,PAK",SUPERKEY INVESTMENTS LLC,80000,0,-80000
R185038,"FERGUSON,MICHAEL J TR &","HAROLD,SYLVIA &",329900,249900,-80000
R261978,"RASMUSSEN,LAUREN J TR",JACKALOPE ENTERPRISE II LLC,80000,0,-80000
R187714,"STOLL,WALTER D TR &","MELANDER,CHRISTINA &",610000,530000,-80000
R217112,"TODD,JOHN L",MAYWOOD HOMES INC,80000,0,-80000
R500206,BODEGA INVESTMENT,"DIACHOK,MARK",980000,899000,-81000
R127954,EVERETT CUSTOM HOMES INC,"CLARK,KYLE S &",431250,350000,-81250
R146599,CASTALDO CONSTRUCTION,"BACHARACH,ROBERT L",81500,0,-81500
R279173,"DYER,MABEL TR","BAY,VIRGINIA L",304000,222500,-81500
R264185,DILUSSO HOMES LLC,DILUSSO HOMES LLC &,82000,0,-82000
R530843,"JAMES,DAN","GOODWIN,STEVEN M JR",400000,318000,-82000
R538447,"WEISETH,ERIK &","KEEBLER,JONATHAN &",440000,358000,-82000
R211335,"LI,HONGBO",RED WAVE INVESTMENTS LLC,82100,0,-82100
R233274,"BRIGHT,WILSON R &","SAUTTER,LACIE E &",835000,752000,-83000
R245439,RP & ASSOCIATES LLC,"MALLETT,AMBER &",295000,211500,-83500
R278691,"WILLIAMS,KEITH S &","FREEMAN,ROBERT L &",339950,256000,-83950
R157823,"OEHLSCHLAGER,STEVE &","OEHLSCHLAGER,STEVE",101600,17500,-84100
R498260,"CUSHMAN,BRITNEY C","TOVAR,GAYLYN",93500,9388,-84112
R199351,"GARLINGTON,JODIE","FLYNN,MICHAEL",170000,85000,-85000
R185861,EVERETT CUSTOM HOMES INC,INTRINSIC HOMES LLC,300000,215000,-85000
R293600,CASH FLOW INVESTMENTS LLC,"TRITT,WILLIAM H",85000,0,-85000
R247264,"DAPP,BRIAN &","DAPP,BRIAN",85000,0,-85000
R113055,"HAWES,DARYL D &","WESTPHAL,SHAUNA",326000,240000,-86000
R116894,"SLIPHER,DEBORA","SLIPHER,DEBORA D",86000,0,-86000
R196658,"HORNER,RODRICK",WYNDYM DEVELOPMENT LLC,86600,0,-86600
R161944,"TELLEZ-RUIZ,INOCENCIO &","TELLEZ-RUIZ,INOCENCIO",87000,0,-87000
R165726,"DAVIDOW,MELISSA","DAVIDOW,MELISSA &",87500,0,-87500
R224641,"LIVINGSTON,PATRICK","LIVINGSTON,KELLEE M",87500,0,-87500
R258684,EWCP LTH FUND LLC,EQUITY WEST LTH POOL I LLC,88000,0,-88000
R247565,"GALLIER,STEPHEN R TR &","FISCHETTE,BERNARD",396000,308000,-88000
R274089,WILLAMETTE VALLEY PROPERTY,"DOLLOWITCH,JOSEPH R",345000,257000,-88000
R163691,"LEAVENWORTH,NATALIE","LEAVENWORTH,NATALIE H",88500,0,-88500
R239762,"SHEPARD,AMOS","GRAY,BENJAMIN",89000,0,-89000
R334256,"LI,HONGBO","LIM,ALICE &",89000,0,-89000
R261640,"STILWELL,JOHN",ENCORE DEVELOPMENT,89000,0,-89000
R147071,"UNDERDAHL,REES &",MAPLELEAF PROPERTIES LLC,89100,0,-89100
R310692,"KIRK,DIANA ET AL",TERRAPIN PROPERTIES LLC,89900,0,-89900
R253485,"MANSFIELD,JEFF &",MASTER BUILDERS & RESTORATION INC,89900,0,-89900
R164079,WBC INVESTMENTS LLC &,"LEONG,PAK &",90000,0,-90000
R236510,"FITZGERALD,WENDY M &","FITZGERALD,WENDY M",90000,0,-90000
R232052,"GOOD,HERBERT A",Sale In Progress,90000,0,-90000
R232052,"GOOD,HERBERT A",LINCOLN INVESTMENTS 4439 LLC,90000,0,-90000
R490141,"GARCIA,JUSTINO","JUAREZ,SUSANA G",90000,0,-90000
R229516,NORTHWEST INVESTMENT,STONEHAVEN PROPERTIES LLC,90000,0,-90000
R239292,"LOCKETT,HENRY L JR &","KANTOR,RICHARD H",90000,0,-90000
R153229,"MOUSSEAU,PAUL C &","ROBERTS,ROBY J &",915000,825000,-90000
R280199,"CHAN,HOI","CHEN,KANG YANG &",90000,0,-90000
R107956,"COLUMBUS,DAVID R","COLUMBUS,DAVID",90000,0,-90000
R268618,"FOX,JOHN M",SNYDER CONSTRUCTION LLC,90150,0,-90150
R268618,"FOX,JOHN M",SNYDER CONSTRUCTION LLC,90150,0,-90150
R118597,"COUCH,RICHARD A &","CLARK,XAVIER A &",329150,239000,-90150
R269789,"KELLER,BRIAN A","KELLER,BRIAN A TR",90500,0,-90500
R212114,"MITCHELL,KENDRICK W",FEDERAL HOME LOAN,418000,327182,-90818
R167658,"MAZURIK,GEORGE","FOSKEY,KRISTAL",200000,109000,-91000
R225537,"LEONG,PAK M",SUPERKEY INVESTMENTS LLC,91000,0,-91000
R115163,LINCOLN TRUST,"RIBNER,NOAH S &",436000,345000,-91000
R338397,"LAM,JASON",GOOD FAMILY REAL ESTATE,91100,0,-91100
R274259,TRUE BREAD PROPERTIES LLC,TRUE BREAD PROPERTIES INC,91200,0,-91200
R108904,"CO,CINDY LAM","CO,CINDY LAM &",91200,0,-91200
R221807,"LIANG,JIAN BO &","TAN,AI YI &",91500,0,-91500
R310720,EWCP LTH FUND LLC,EQUITY WEST LTH POOL I LLC,92000,0,-92000
R268248,"SWIFT,DAN &","ISELI,ANDRE",92000,0,-92000
R178761,"ARMBRUST,BRAD","ARMBRUST,BRAD",92000,0,-92000
R187876,"WOODS,PAUL O TR &","RELIN,DAVID O &",785000,692500,-92500
R224189,PEOPLE OF PRAISE,"FRAGA,CHARLES M &",157500,65000,-92500
R339289,"YANG,LI MEI",WBC INVESTMENTS LLC,93000,0,-93000
R145940,"LI,HONGBO","LIM,ALICE &",93000,0,-93000
R120144,"CASTALDO,PAOLA",CASTALDO CONSTRUCTION,93000,0,-93000
R242020,"CLARK,JUSTIN H","DISTERHOFT,CALE F &",269400,176300,-93100
R289687,"RICK,MICHAEL D &","ANDERSON,SHANNAH D",255750,162500,-93250
R199973,"CHEUNG,MARIANA","FUN,CHEUNG SUK &",93300,0,-93300
R542317,"ZUNIGA,ANGEL M",HSBC BANK USA NATIONAL,228500,135000,-93500
R113578,"GIBSON,SANDRA L","COVINGTON,ROBERT C",252000,158500,-93500
R245396,"SINGER,ANDY","SINGER,ANDREW &",93500,0,-93500
R221629,FEDERAL HOME LOAN,"HRABAL,DAVE",234000,140240,-93760
R276827,"BEGG,KAAREN &","BEGG,KAAREN",94000,0,-94000
R231144,"PROZAKI,MARK",WBC INVESTMENTS LLC,94000,0,-94000
R249241,"MILLS,KATHERINE &",AMERICAN HOMES 4 RENT,359500,265000,-94500
R283538,"KARAM,KHALIL &","KARAM,KHALIL &",95000,0,-95000
R160085,"DAVIS,DWAYNE &",YD PROPERTIES,95000,0,-95000
R589644,"COMBS,TYLER C",THE ABLETON GROUP INC,95000,0,-95000
R531490,TCH VENTURES LLC,FASTRACK REDEVELOPMENT LLC,95000,0,-95000
R112420,"BACHHUBER,STEPHEN R &","BACHHUBER,IRENE J TR &",95000,0,-95000
R135826,PIERCE INVESTMENT,"GARCELON,ELAINE L TR &",235000,140000,-95000
R550592,"LE,BRIAN","LE,BRIAN &",95000,0,-95000
R124397,"SADO,NEGUISSE",APEX ENTERPRISE TEAM LLC,95000,0,-95000
R575091,"CAINE,ANDREW &","STARR,JEFFREY A &",615670,520000,-95670
R278778,"ONCHI,JOE M TR ET AL","KOTSAKIS,JOHN P &",254900,159000,-95900
R146631,"LEONG,PAK","GOOD,HERBERT",96000,0,-96000
R172441,"CHEN,HELEN",DA CHENG INC,96000,0,-96000
R229547,"LEONG,PAK","LEONG,PAK &",96000,0,-96000
R299175,FULL HOUSE PROPERTIES LLC,"KATAKKAR,SURESH B",506000,410000,-96000
R120171,"LEONG,PAK","LEONG,PAK &",96000,0,-96000
R302502,"ZAVOSHY,SHAW",SELARNO 61 LLC,96000,0,-96000
R217027,"PETERS,HAROLD W","PETERS,HAROLD W EST OF",96500,0,-96500
R309523,"BLECHMAN,FELA-20% &","BLECHMAN,STEVE-80% &",485000,388000,-97000
R242562,"NUSS,MICHAEL",ENCORE DEVELOPMENT,97249,0,-97249
R311536,PRIZE HOMES LLC,"SCHWARTZ,WENDI &",97500,0,-97500
R159673,"HOOGLAND,JAN &","UPHAM,DONALD S &",755000,657500,-97500
R124368,"SAKYS,NICOLE",WEST COAST DEVELOPMENT,98000,0,-98000
R161309,"PROFFITT,MONETTE K TR","COVERT,CHRISTOPHER B",310000,212000,-98000
R255280,"SAMIEE,PARVIZ TR &","MCMILLAN,SHIRLEY H &",632000,534000,-98000
R164046,"NUSOM,BRAD","NUSOM,BRADLEY &",98029,0,-98029
R159203,"MO,JOY &","MO,JOY",98340,0,-98340
R100820,EDEN ENTERPRISES LLC,INTRINSIC HOMES LLC,480000,381500,-98500
R133266,"OCHS,JON &","OCHS,NATASHA &",99000,0,-99000
R156331,"PENN,DEBORAH L","PENN,DEBORAH L &",99400,0,-99400
R228820,"SKORO,MATE",SKORO HOMES LLC,99600,0,-99600
R487477,"LU,DANG",2919 SE 90TH PLACE LLC,99750,0,-99750
R337122,KEN LEAVENS PROPERTIES INC,PEACH TREE MEADOWS LLC,99750,0,-99750
R122876,"BURKHOLDER,LEON",DONAA CONSTRUCTION INC,99900,0,-99900
R194685,"MAXWELL,DAVID","MENGIS,GREG",100000,0,-100000
R128835,"OLSHIN,ANDREW M",2623 WATER STREET LLC,100000,0,-100000
R118854,GIBSON HOMES INC,"WINGFIELD,TINA D",100000,0,-100000
R193479,ARGONAUT GROUP LLC,MAI PROPERTIES LLC,250000,150000,-100000
R106227,"LI,HONGBO",RED WAVE INVESTMENTS LLC,100000,0,-100000
R291199,"MEADOWS,RHONDA &","COOLEY,KRISTIN C &",675000,575000,-100000
R120268,"LEONG,PAK","LEONG,PAK &",100000,0,-100000
R153182,"TAYLOR,HARRY A III &","SCHLESINGER,BOB &",900000,800000,-100000
R165728,"MULLEN,ROY","MULLEN,ROY &",100000,0,-100000
R253487,"ANDERSON,PHILLIP J","ANDERSON,PHILLIP J &",100000,0,-100000
R205436,"FENG,FANG","FENG,FANG QING",100000,0,-100000
R283770,"ABSTON,CLYDE E",165/CONCORD LLC,100000,0,-100000
R146720,"REGIER,JOHN D",JDR PROPERTY INVESTMENTS LLC,100400,0,-100400
R225439,"GILLINGHAM,AARON","GILLINGHAM,AARON L",100550,0,-100550
R224756,"MELHUISH,KATHLEEN &","MELHUISH,KATHLEEN &",100900,0,-100900
R252082,"SAECHAO,XOU C","CHAO,VERN HIN",101000,0,-101000
R232552,GOOD FAMILY REAL ESTATE LLC,"PHAM,MARY &",101000,0,-101000
R216809,"ENSIGN,AARON",ENSIGN INVESTMENT LLC,101000,0,-101000
R205722,"YODER,CHRISTIAN G &","ANDERSON,ERIC B &",566900,465000,-101900
R146232,"LEONG,PAK","LEONG,PAK &",102000,0,-102000
R498260,"VALDEZ,GUILLERMINA N","VALDEZ,GUILLERMINA N",102000,0,-102000
R331399,"SUND,DOUGLAS","BORN,DAVID C &",450000,348000,-102000
R139960,"SHEPARD,AMOS &",Sale In Progress,102200,0,-102200
R139960,"SHEPARD,AMOS &",SHEPARD BROTHER'S,102200,0,-102200
R518130,"TAWFIK,ESSAM",B & E PROPERTY 1 LLC,102885,0,-102885
R236101,"BRASSINNE,CHRISTIAN J","BRASSINNE,CHRISTIAN J &",103000,0,-103000
R242843,"SANDE,ROBERT S &","SWANBERG,THERESA M TR &",588000,485000,-103000
R290107,"SAKYS,CHRIS",WEST COAST DEVELOPMENT LLC,103100,0,-103100
R186771,"ROBERTS,CRAIG S &","HARA,MOTOAKI &",392500,289000,-103500
R287130,"FORMAN,MICHAEL L TR","FORMAN,MICHAEL L",104000,0,-104000
R327612,"RAU,HEATHER &",DILUSSO HOMES LLC,343650,239142,-104508
R149370,KDO ENTERPRISES LLC,"OLSON,JOHN D",105000,0,-105000
R218695,"PFEFER,CHAD T &","QUINN,MICHAEL G JR &",595000,490000,-105000
R141652,"BLIXSETH,MORGAN L","KNIGHT,ASHLEY B &",685000,580000,-105000
R258776,"MAZZZANTI,PATRICIA","MAZZANTI,PATRICIA &",105000,0,-105000
R118220,COLUMBIA REDEVELOPMENT LLC,"MILLER,KAREN E &",400000,295000,-105000
R308639,"TAMA-SWEET,SHOSHON","OAKLEY,CAROLYN",105357,0,-105357
R212230,"LI,HONGBO",RED WAVE INVESTMENTS LLC,106000,0,-106000
R135853,"LI,HONGBO","LEONG,PAK",106000,0,-106000
R277401,"ESTERS,TONI G",GORILLA CAPITAL WA 6 LLC,260000,153700,-106300
R161444,ALL AROUND HAWAII LLC-40% &,ELDA OR FV LLC,555000,448500,-106500
R303158,"FOX,JONATHON",SNYDER CONSTRUCTION LLC,107000,0,-107000
R334290,"XU,YANNONG LEI","XU,YANNONG LEI &",107000,0,-107000
R253839,"IRWIN,ROBERT &",CONSOLIDATED DESIGNS LLC,107000,0,-107000
R243885,"FENN,JAMES L","FENN,JAMES L &",107000,0,-107000
R279008,"STEVENSON,RONALD L TR &","LANGSTON,DENNIS E",379000,271950,-107050
R235241,"LEONG,PAK",SUPERKEY INVESTMENTS LLC,108000,0,-108000
R244189,"FITZPATRICK,EDWARD J","ALTREE,MARTA",455000,347000,-108000
R183615,"MYERS,KELLY JO","MYERS,KELLY JO &",108000,0,-108000
R179052,EVERETT CUSTOM HOMES INC,"FULTON,LAUREN A",487900,379000,-108900
R132115,"CONRADI,KAREN E &","BARR-HERTEL,EVERETT &",298000,189000,-109000
R574767,"MOU,JACOB M &",PINE J LLC,110000,0,-110000
R193490,"NG,KIT",KN ONE LLC,110000,0,-110000
R587358,"HALL,DAVID B &","FREUDMANN,GIDEON",859000,749000,-110000
R155859,RP & ASSOCIATES LLC,CLUNAS FUNDING GROUP INC,110000,0,-110000
R239168,"LI,HONGBO","LI,HONGBO &",110000,0,-110000
R337819,"KARAM,FARES","KARAM,FARES-50% &",110000,0,-110000
R109794,HTV PROPERTIES LLC,"TU,KIM THIEN-75% &",110000,0,-110000
R238621,"LI,HONGBO &","LEONG,PAK &",110000,0,-110000
R209920,"LI,HONGBO","LIM,ALICE &",110000,0,-110000
R488080,"BURLINGAME,BRETT &",RENTALS PLUS LLC,111000,0,-111000
R251914,"SODEN,STEPHEN &","SODEN,STEVE",111500,0,-111500
R277807,"MUIR,LORI A R","GRIFFIN,DOMINIC B &",465000,353200,-111800
R276798,"SETTLEMIER,DAVID E","SETTLEMIER,DAVID E",112000,0,-112000
R173912,"HO,NHON &","HO,NHON DUY &",112500,0,-112500
R266235,"SWINNEY,FRANK C TR &","VALERIO,DONALD &",660000,547000,-113000
R291627,"HARRIS,JANEAN S","DORAN,BRIAN M",733000,619750,-113250
R233159,"FUJISAKI,AYAKO","FUJISAKI,AYAKO &",114000,0,-114000
R125398,"ZENG,FANQING",BUTTERFLY RENOVATIONS LLC,114000,0,-114000
R242038,"CARR,RAYMOND &","HARMON,KITTY C &",114500,0,-114500
R127000,"MANSETH,HANS J","MOSER,ROBERT J &",274800,160000,-114800
R271945,"BURKHOLDER,LEON S",DONAA CONSTRUCTION INC,114900,0,-114900
R120753,"LI,HONGBO",RED WAVE INVESTMENTS LLC,114900,0,-114900
R238560,"MALIDORE,ALICE G","MALIDORE,ALICE G TR",114900,0,-114900
R165749,PS & SH PROPERTIES LLC,"HOPKINS,STEVEN J &",115000,0,-115000
R239897,PHAM REI-OR LLC,"PHAM,TRI &",115000,0,-115000
R172044,"SANCHEZ,BRAD","SANCHEZ,BRAD &",115000,0,-115000
R217532,"BLASHCHISHENA,LYUDMILA N","BLASHCHISHENA,LYUDMILA N &",115000,0,-115000
R244282,"YANG,LIMEI",WBC INVESTMENTS LLC,115000,0,-115000
R146302,"VALDOVINO,DANIEL &","RAMOS,KAYLA &",115000,0,-115000
R526074,"RIEDER,RAYLENE R",TK DORO'S LLC,415000,300000,-115000
R206765,"QIANG,LI JIA","CHEN,YAN NA",116000,0,-116000
R195256,"SCHMIDT,LEAH","YOUNG,ANTHONY",116000,0,-116000
R153851,"YOUNG,BARBARA A",BURTON AKERS LLC,301000,185000,-116000
R133118,"HOOPER,CRAIG",H3 HOLDINGS LLC,117000,0,-117000
R293700,"HSU,CHINGTAI",TENHOUSE PROPERTY LLC,117000,0,-117000
R504548,"YANG,YUAN","GUAN,SHU M",117000,0,-117000
R110388,"GWILLIAM,LOREN P &","GWILLIAM,LOREN P &",117027,0,-117027
R235168,"HAWTHORNE,TURNER JR &","HAWTHORNE,TURNER JR &",117400,0,-117400
R117599,"BERRY,DUNCAN &","STARKES,JUNE",770000,652520,-117480
R527396,"MOLINA,SERGIO &","MOLINA,SERGIO TR &",117500,0,-117500
R145725,"SHEPHERD,AURA","SHEPHERD,AURA &",118000,0,-118000
R145725,"SHEPHERD,AURA","SHEPHERD,AURA &",118000,0,-118000
R194214,"KARAS,DENNIS J TR &","KARAS,DENNIS J TR ET AL",310500,192000,-118500
R115531,BKB INVESTMENTS LLC,BKB INVESTMENTS LLC,119000,0,-119000
R236893,"DAVIS,BETTY J","DAVIS,BETTY J TR",119900,0,-119900
R121744,"MUHAREB,ABDALLAH","MUHAREB,GEORGINA",120000,100,-119900
R158340,"RUPAR,DAVID &","RUPAR,DAVID P",120000,0,-120000
R244141,"COOLEY,CHERI","COOLEY,CHERI",120000,0,-120000
R274668,EWCP LTH FUND LLC,EQUITY WEST LTH POOL I LLC,120000,0,-120000
R237173,"GROSS,CHRISTINE &",GOLDLEAF PROPERTIES LLC,120000,0,-120000
R317572,"LI,HONGBO",RED WAVE INVESTMENTS LLC,120000,0,-120000
R302132,"SHEPARD,AMOS","FARIS,STUART",120000,0,-120000
R251449,"MILLER,MEGAN L &","MILLER,MEGAN L",120000,0,-120000
R289282,"POTTENGER,BRENT &","POTTENGER,BRENT &",120000,0,-120000
R194298,"COLLINS,ROBERT &","BYRNES,MARY C TR",120000,0,-120000
R122483,"CONNELLY,MARK &","CONNELLY,MARK &",120000,0,-120000
R145950,"SABLADA,NENITA",FORTUNE RENTAL LLC,120000,0,-120000
R231135,"NASH,SCOTT",SPH INVESTMENTS LLC,120100,0,-120100
R133080,"KIRK,DIANA &","KIRK,DIANA",120200,0,-120200
R336083,"LI,HONGBO",Sale In Progress,120500,0,-120500
R336083,"LI,HONGBO",RED WAVE INVESTMENTS LLC,120500,0,-120500
R236442,"STINTON-BROWN,CYNTHIA","CARSON,CYNTHIA L",121500,0,-121500
R292817,"GRUNWALD,ROBERT L &","GRUNWALD,ROBERT L TR &",121500,0,-121500
R543895,"BLUMENBERG,WESLEY T &","LUI,KIT HUNG",249000,127000,-122000
R336436,"HICK,KENNETH W","GREENFIELD,JAMES R",122500,0,-122500
R336436,"HICK,KENNETH W",CONSUMER SOLUTIONS REO LLC,122500,0,-122500
R201871,"THOMPSON,MARVIN","THOMPSON,MARVIN R &",124000,0,-124000
R163396,"BEC,IOAN","BEC,IOAN &",124500,0,-124500
R296339,"ADAMS,DOMENICA A","ADAMS,DOMENICA A &",124900,0,-124900
R233158,"LYONS,JOSEPH D","LYONS,JESSICA D-50% &",125000,0,-125000
R337345,HOMES NEW TO YOU INC,PC RESOURCES LLC,125000,0,-125000
R279523,"NICHOLSON,JAMES",3124 SE 165TH LLC,125000,0,-125000
R210074,"DVORAK,STANLEY","DVORAK,LELA",125000,0,-125000
R218329,"WILLIAMS,DANIEL K","BUTLER,DANIEL R TR",125000,0,-125000
R283464,"RUBINE,WILLIAM &","RUBINE,WILLIAM &",125000,0,-125000
R197873,"CUMMING,ROXANNE","CUMMING,ROXANNE TR",125000,0,-125000
R165954,"HICK,KENNETH W","HICK,KENNETH W",125000,0,-125000
R181517,"MCBEAIN,KELLY J","FAST,JENNIFER L",125000,0,-125000
R337345,HOMES NEW TO YOU INC,PC RESOURCES LLC,125000,0,-125000
R216884,EWCP LTH FUND LLC,EQUITY WEST LTH POOL I LLC,125000,0,-125000
R279646,EWCP LTH FUND LLC,EQUITY WEST LTH POOL I LLC,125000,0,-125000
R317788,"WHITESIDE,CAROLE A &","WHITESIDE,CAROLE A TR-1/2 &",125000,0,-125000
R107762,PRIORITY PROPERTIES LLC,"BRAINARD,DUANE L &",125000,0,-125000
R282440,"FOTEFF,PAT T &","FOTEFF,PAT T &",125000,0,-125000
R218329,"WILLIAMS,DANIEL K","BUTLER,DANIEL R TR",125000,0,-125000
R149340,"OLSON,SCOTT L",SCOTT OLSON HOMES LLC,125000,0,-125000
R121742,PIVOT LLC,"PRITCHARD,JEAN M",125100,0,-125100
R138310,"METKO,TIMOTHY J","METKO,TIMOTHY J &",125200,0,-125200
R145018,"HOLZMAN,TRENT R &","HOLZMAN,TRENT R",125250,0,-125250
R196588,"HAMM,VALARIE J","HAMM,VALARIE",125500,0,-125500
R249424,"KINNE,JARED",RED GAP HOLDINGS LLC,126000,0,-126000
R235278,"STRUTZ,LAWRENCE",Sale In Progress,126000,0,-126000
R235278,"STRUTZ,LAWRENCE",JT & LS HOLDINGS LLC,126000,0,-126000
R553168,"IIAMS,CARL","IIAMS,CARLTON C",126000,0,-126000
R138251,"KAZAKOV,PETR","KAZAKOV,PETR &",126000,0,-126000
R197165,"WOLF,BRUCE A &","WOLF,BRUCE A",126000,0,-126000
R305325,"ANKENEY,DIANA","ANKENEY,DIANA TR",126000,0,-126000
R224591,"MAW,GAIL S &","REN,JIAHUI",126000,0,-126000
R158795,"LI,HONGBO",RED WAVE INVESTMENTS LLC,126320,0,-126320
R158795,"LI,HONGBO",RED WAVE INVESTMENT LLC,126320,0,-126320
R566609,"SWEENEY,JESSE N &","SWEENEY,JESSE N &",126500,0,-126500
R282997,THE GRSW STEWART REAL,"DAGOSTINO,FRANK P &",550000,423250,-126750
R291281,"CASSANDRA,BRANDY","LINDBLOM,IAN",505000,378000,-127000
R106079,"CROUCH,CHAD &","CROUCH,CHAD J &",127175,0,-127175
R161439,"MEJIA,JAIME &","MEJIA,VALERIE A",128000,0,-128000
R281837,"CHAN,YUE KOK","CHAN,YUE KOK &",128000,0,-128000
R125032,"BARSKIN,D",MCS1 LLC,250000,122000,-128000
R220474,"KIRK,MICHAEL R",LUCI CORPORATION,128250,0,-128250
R334794,"GILTNER,TERRY &","GILTNER,ROLLIN V",129000,0,-129000
R532882,"BREWER,MARTYN-50% &","RICHARDSON,DAVID A",804500,675000,-129500
R494259,"WELLS,DEAN R &","WELLS,DEAN R &",129900,0,-129900
R183849,OCEAN EQUITY GROUP LLC,"GOFF,STARLA",129900,0,-129900
R341410,"CUPPER,HENRY A &",Sale In Progress,130000,0,-130000
R113138,"MARCHETTI,NINO &","NORLING,WILLIAM G &",730000,600000,-130000
R300720,"AKROUSH,RADWAN &",AKROUSH HOMES LLC,130000,0,-130000
R121389,"HAUBNER,MATTHEW R","NEUKIRCH,KELLY &",570000,440000,-130000
R335216,"LIANG,RICKY","LIANG,RICKY-20% &",130000,0,-130000
R173474,"RICKLES,NORMAN A &","MEADS,PATRICIA J &",535000,405000,-130000
R145065,"HICK,KENNETH W","GREENFIELD,JAMES R",130000,0,-130000
R189235,"FARVER,BENJAMIN W &","DUFFY,REGAN M &",905000,775000,-130000
R290433,ONBOARD CAPITAL CO,RMJ PROPERTIES LLC,130000,0,-130000
R213733,ACRA GROUP INC,ACRA GROUP INC,130000,0,-130000
R145596,"WILSON,ROBERT D &","WILSON,ROBERT D TR",130000,0,-130000
R108197,"KETEL,SCOTT M &","KETEL,SETH E",130000,0,-130000
R110171,"KUEHN,JOANN","KUEHN,JOANN C",130000,0,-130000
R156386,"HUFFT,AMY",835 NE 114TH AVENUE LLC,130000,0,-130000
R193460,"PHAM,HONG","PHAM,HONG &",130000,0,-130000
R159105,"KARIN,DAMIR",DK HOMES LLC,130000,0,-130000
R232685,"HAWKEY,DAN",HALF DOLLAR LLC,130000,0,-130000
R160230,"LIPPS,HARVEY","LIPPS,HARVEY R TR",130500,0,-130500
R336518,"LETT,STEPHEN K &","LETT,STEPHEN K",130900,0,-130900
R249794,"SINGH,VIJAY","SINGH,VIJAY &",131000,0,-131000
R261113,"STILLHARD,JANICE &",CJ STILLHARD FAMILY,131500,0,-131500
R186268,"CODE,ROBERT-1/3 &",BCC PROPERTIES 1 LLC,131500,0,-131500
R272363,JAMES ROYCE INVESTMENTS LLC,"MORRIS,LINDA J",131891,0,-131891
R111790,"MENG,DONNA L TR","WATERMAN,ANDREW II",450000,318000,-132000
R263536,EWCP LTH FUND LLC,EQUITY WEST LTH POOL I LLC,132000,0,-132000
R239761,"SHEPARD,AMOS &",SHEPARD BROTHERS,132000,0,-132000
R120952,EWCP LTH FUND LLC,EQUITY WEST LTH POOL I LLC,132000,0,-132000
R202067,"GILMAN,LAURRIEN","BARRETT,LEONARD E III &",268000,135000,-133000
R283119,"BRIM,JULIA","BRIM,JULIA-2/3 &",205000,71667,-133333
R327721,"SMITH,RICKY D","HU,WILLIAM Y &",629000,495000,-134000
R179494,"KIMM,NAOMI","KIMM,NAOMI &",134900,0,-134900
R241078,TEAM CAPITAL & INVESTMENT,"HALL,JOSHUA",134900,0,-134900
R537029,"FETTERS,KEN &","FETTERS,REBECCA",135000,0,-135000
R120976,"KIEN,HOANG-SA","KIEN,SA HOANG",135000,0,-135000
R262084,"COOLEY,CHERI","COOLEY,CHERI",135000,0,-135000
R274670,"GEARHART,COURTNEY M","GEARHART,JOHN W &",135000,0,-135000
R164810,"KAZAKOV,SERGEY","KAZAKOV,SERGEY",135000,0,-135000
R105898,TTM CAPITAL FUNDING LLC &,RIDGEWAY PROPERTIES LLC,135000,0,-135000
R216959,"BUTH-HALL,STEPHANIE","BUTH-HALL,STEPHANIE",135000,0,-135000
R249818,"FERNANDEZ,NOLVIA","FERNANDEZ,NOLVIA ET AL",135000,0,-135000
R249818,"FERNANDEZ,NOLVIA","FERNANDEZ,NOLVIA ET AL",135000,0,-135000
R109846,"GEBREYESUS,TESHALE T","GEBREYESUS,TESHALE T &",135000,0,-135000
R202321,"PICKLES,DOROTHY &","PICKLES,JOSHUA D",135000,0,-135000
R125675,"DINIHANIAN,SUSAN B","DINIHANIAN,SUSAN B TR",135000,0,-135000
R264691,"SHIRYAYEV,MIKHAIL","SHIRYAYEV,MIKHAIL &",135100,0,-135100
R557689,"YERKE,BARBARA A &","YERKE,BARBARA A",135115,0,-135115
R220360,CREO PROPERTIES LLC,JONAY PROPERTIES LLC,135299,0,-135299
R167981,TTM CAPITAL FUNDING LLC,OZ EQUITY PARTNERS LLC,135900,0,-135900
R242268,"PATTEE,EMMA &","PATTEE,EMMA",144000,8000,-136000
R339285,"GILLE,JANE","GILLE,JANE TR",136000,0,-136000
R218963,"RAVEICA,DAN &","AVIEL,DAVID B &",136000,0,-136000
R276453,"COOLEY,CHERI","COOLEY,CHERI",136100,0,-136100
R135348,"HASSON,MARIAN B &","RAMSBY,CLAUDIA E",137000,0,-137000
R218341,"CACH,MARK J","CACH,MARK J TR",138000,0,-138000
R183179,"LEE,NANCY TSAI",Sale In Progress,138000,0,-138000
R145271,MOUNT STORM PROPERTIES LLC,4843 NE GRAND LLC,138000,0,-138000
R244098,"ADAIR,DENNIS W &","ADAIR,AMY ANNE &",138000,0,-138000
R145102,"JOHNSON,MARYAM J &","NEHRING,CURTIS &",145000,7000,-138000
R317637,"GUNNELL,BENJAMIN","GUNNELL,BENJAMIN E",138000,0,-138000
R145271,MOUNT STORM PROPERTIES LLC,4843 NE GRAND LLC,138000,0,-138000
R319990,"COTO,JOSE R",Sale In Progress,138000,0,-138000
R183179,"LEE,NANCY TSAI","LEE,GEORGE S &",138000,0,-138000
R319990,"COTO,JOSE R","COTO,JOSE R TR &",138000,0,-138000
R208408,"AUSTIN,DAVE",REYEM INDUSTRIES LLC,138500,0,-138500
R177572,"TARZIAN,PATRICIA","DIRKS,NICOLLE M",499000,360000,-139000
R176199,"TAM,MEI TO","TAM,MEI TO TR",139000,0,-139000
R540701,"POLAS,GEORGE &","POLAS,BENJAMIN &",139000,0,-139000
R197288,"BAIRD,CHRIS",ENCORE DEVELOPMENT,139000,0,-139000
R201992,"REED,HOWARD F &",U S BANK NATIONAL,314000,174600,-139400
R111461,"RASMUSSEN,RICHARD J","RASMUSSEN,RICHARD J EST OF",139500,0,-139500
R248625,ONBOARD CAPITAL COMPANY,RMJ PROPERTIES LLC,140000,0,-140000
R309605,MAYUCHI CAPITAL LIMITED,CREO PROPERTIES LLC,140000,0,-140000
R251151,"STURGIS,CHRIS &","BURNETT,DELENA &",140000,0,-140000
R244332,EWCP LTH FUND LLC,EQUITY WEST LTH POOL I LLC,140000,0,-140000
R251151,"STURGIS,CHRIS &","BURNETT,DELENA &",140000,0,-140000
R251151,"STURGIS,CHRIS &","STURGIS,CHRIS &",140000,0,-140000
R178508,"BARBER,WANDA","BARBER,WANDA F TR",140000,0,-140000
R113643,"HAMILTON,RONALD M &","HAMILTON,ROSLYN M",140000,0,-140000
R195594,"MAY,BEN",JONAY PROPERTIES LLC,140000,0,-140000
R248773,"MATHABANE,GAIL E",GEM RENTAL HOUSES LLC,140000,0,-140000
R588539,"MOSCATO,LOUIS J &","MOSCATO,LOUIS J &",280000,140000,-140000
R248904,GREENWING RESTORATIONS LLC,8714 N PORTSMOUTH AVENUE LLC,140000,0,-140000
R240078,"CHEN,MEI YAN &","CHAN,CHI FUNG",140000,0,-140000
R135913,"SCHMIDT,SHARI A","SCHMIDT,SHARI A TR",140000,0,-140000
R250815,ACP AUTOBODY LLC,"PEREZ,AVERTANO C",140000,0,-140000
R269487,NEW BEGINNINGS LLC,NEW BEGINNINGS CR LLC,141400,0,-141400
R294214,"WRENN,ROBERT L","WRENN,ROBERT L &",141750,0,-141750
R239758,"GOOSTREE,RICHARD D","GOOSTREE,RICHARD D &",142000,0,-142000
R193454,"YIH,WEI YUNG &","YIH,SHAN LIN",142000,0,-142000
R211877,NEW BEGINNINGS LLC,NEW BEGINNINGS CR LLC,142000,0,-142000
R292249,PDX RENOVATIONS LLC,"TAYLOR,JOSEPH P",142000,0,-142000
R296776,K BREDENKAMP PROPERTIES LLC,Sale In Progress,142500,0,-142500
R296776,K BREDENKAMP PROPERTIES LLC,"BREDENKAMP,WYATT K",142500,0,-142500
R318879,FRANK INVESTMENT GROUP LLC,"FRANK,WILLIAM B",143000,0,-143000
R133493,"GRIDER,MARK",CNT DEVELOPMENT LLC,144000,0,-144000
R239077,BKB INVESTMENTS LLC,BKB INVESTMENTS LLC,145000,0,-145000
R228886,PARK PLACE PARTNERS LLC,"STANLEY,DEBORAH",145000,0,-145000
R227961,"BROUSSARD,WENDY &","BROUSSARD,WENDY &",145000,0,-145000
R123117,"MUNGUIA,JOSE D J &","MUNGUIA MURILLO,JOSE D J &",145000,0,-145000
R124653,"MARTIN,GREG","MARTIN,GREGORY K &",145000,0,-145000
R248819,"ELLIS,LISA M","ELLIS,LISA M &",145000,0,-145000
R532881,"BRINKERHOFF,RUSSELL","FARMER,JOHN G &",760000,615000,-145000
R213162,"GIBSON,STEVE",PNW CONSTRUCTION INC,145000,0,-145000
R227961,"BROUSSARD,WENDY &","BROUSSARD,WENDY &",145000,0,-145000
R238687,"TRAVER,JEFFERY H",HORIZON MANAGEMENT GROUP LLC,145000,0,-145000
R119242,"LE,HONG VAN &","HUU,LE TUONG &",146000,0,-146000
R277818,"TAWFIK,ESSAM",B & E PROPERTY 1 LLC,147000,0,-147000
R600939,"ANDERSON,GREGORY J","ANDERSON,GREGORY J &",147400,0,-147400
R238101,"SHEPARD,AMOS",SHEPARD BROTHERS,147500,0,-147500
R184164,"TENNANT,JOHN J III",JT & LS HOLDINGS LLC,147619,0,-147619
R285636,"DOLLINGER,TODD","DOLLINGER,TODD B TR &",147900,0,-147900
R242040,"DOYLE,MATTHEW &","KINNEY,JEFFREY L &",148000,0,-148000
R119240,"CHEN,WEN HAN","CHEN,FU JIN",149000,0,-149000
R296700,"CHEN,HUIMIN &","CHEN,HUIMIN TR &",149000,0,-149000
R158763,"BRAATEN,KURT &","SCOTT,BENJAMIN &",549000,399900,-149100
R519858,"BOHRER,SUSAN L",SOLID ROCK PROPERTIES LLC,149950,0,-149950
R245354,URBAN PROPERTIES LLC,URBAN PROPERTIES LLC ET AL,150000,0,-150000
R240938,PENSCO TRUST CO CSTDN,THE PENSCO TRUST COMPANY CSTDN,150000,0,-150000
R252461,"LUM,MONIQUE",MOHO OREGON LLC,150000,0,-150000
R252461,"LUM,MONIQUE",MOHO OREGON LLC,150000,0,-150000
R337096,CITY OF PORTLAND,CITY OF PORTLAND,150000,0,-150000
R335279,COLUMBIA CARE SERVICES INC,COLUMBIACARE SERVICES INC,150000,0,-150000
R112260,"MINCH,MATTHEW","MINCH,MATTHEW &",150000,0,-150000
R308507,"STILWELL,JOHN J &",ENCORE DEVELOPMENT,150000,0,-150000
R254141,"GEBREYESUS,TESHALE","GEBREYESUS,TESHALE T &",150000,0,-150000
R201872,"PEDERSON,JON",NORTHWEST REAL ESTATE,150000,0,-150000
R299031,"BECK,ETHAN &",K STREET PROPERTY LLC,150000,0,-150000
R136368,EWCP LTH FUND LLC,EQUITY WEST LTH POOL I LLC,150000,0,-150000
R232386,OCEAN EQUITY GROUP LLC,"FREED,DENNIS N",150000,0,-150000
R299031,"BECK,ETHAN &",K STREET PROPERTY LLC,150000,0,-150000
R332313,"WARTON,JOHN","WARTON,JOHN H JR TR",150000,0,-150000
R257404,"PERRIN,PETER M",THE SHOPS AT BROOKLYN YARD,150000,0,-150000
R130041,"MEGEDYUK,YELENA","MEGEDYUK,YELENA &",150000,0,-150000
R162031,BOONDOGGLE LLC,Sale In Progress,150000,0,-150000
R342234,"USKOSKI,GLENN R TR &","MOYER,JOANNA &",650000,499900,-150100
R331076,"POLLOCK,DONALD E",DEP LLC,151000,0,-151000
R103320,"NEWEY,MARK",RFPR LLC,151250,0,-151250
R270104,"COFFEY,JESS &","COFFEY,BRIAN M &",152000,0,-152000
R336423,"NICHOLSON,JAMES W",7958 SE 64TH LLC,152000,0,-152000
R247915,"SUSSMAN,MARC &","SUSSMAN,MARC TR &",152000,0,-152000
R279166,"SIMPSON,EVERETT E TR &","FINNEY,JOAN D",349950,197000,-152950
R291980,"FUSSELL,GEORGE",WILLAMETTE VALLEY PROPERTY,153000,0,-153000
R108405,TEAM CAPITAL & INVESTMENT,"LEITGEB,IRWIN",154000,0,-154000
R185915,"CHARLESWORTH,MARK K &",GOOD DAY LLC,154300,0,-154300
R134908,EWCP LTH FUND LLC,EQUITY WEST LTH POOL I LLC,155000,0,-155000
R178489,HOMEAGAIN RENOVATIONS INC,"ARIEL,YORAM",155000,0,-155000
R311901,"KING,LECHERYL L","BUTLER,DANIEL R TR",155000,0,-155000
R160005,"DENTON,CHRISTINE","DENTON,CHRISTINE &",155000,0,-155000
R558863,"EWING,RONALD L &","EWING,TRACY S",155000,0,-155000
R155253,"WHITE,ANNETTE","WHITE,PIERRE G &",155000,0,-155000
R216417,"ELLERD,RICHARD &","REEVES,CHAD &",155000,0,-155000
R128110,"STILWELL,JOHN",ENCORE DEVELOPMENT,155000,0,-155000
R312659,"BRODIE,DIANE",PHYBE LLC,155000,0,-155000
R178489,HOMEAGAIN RENOVATIONS INC,"ARIEL,YORAM",155000,0,-155000
R282458,DILUSSO HOME LLC,ENCORE DEVELOPMENT,155150,0,-155150
R266622,"LAUFMAN,DEBBIE D",HOMES NEW TO YOU INC,156000,0,-156000
R114946,"LUTZ,DAVID &","PRIDDY,BETSY",173000,16750,-156250
R333433,CES LEE EXCHANGE LLC,"LEE,DAVID E &",157000,0,-157000
R305243,"JONES,DONALD R &","DRECHSLER,DAVID &",524000,366500,-157500
R198043,"HELLUMS,VIRDEN A TR","BLACK,SARAH L C",157500,0,-157500
R103605,"LANGE,GORDON","LANGE,GORDON S TR",157500,0,-157500
R131895,"MCMENAMIN,JAMES","HORN,CAITLIN &",158000,0,-158000
R261872,"HICK,KENNETH","GREENFIELD,JAMES R",158000,0,-158000
R183076,"LEONARD,IN-GU","BECK,HANNA",158500,0,-158500
R178626,"REGIER,JOHN",JDR PROPERTY INVESTMENTS LLC,158500,0,-158500
R233632,"SWAN,CHARLIE",RAMONA HOUSE LLC,159000,0,-159000
R101838,VOLUNTEERS OF AMERICA,SACRAMENTO STREET HOUSING LLC,160000,100,-159900
R340417,"BENAVIDES,ELIZABETH C","MOROTE,DARIO A-1/3 &",160000,0,-160000
R210958,CASH FOR HOMES LLC,K & P REAL ESTATE LLC,160000,0,-160000
R311496,MAYUCHI CAPITAL LLC,CREO PROPERTIES LLC,160000,0,-160000
R312091,"HARPER,HANS &","HARPER,HANS S &",160000,0,-160000
R238250,"GARCIA,JUSTINO &","JUAREZ,SUSANA",160000,0,-160000
R118086,"BLASCHCHISHENA,LYUDMILA N","BLASHCHISHENA,LYUDMILA N &",160000,0,-160000
R333379,"NGUYEN,CUONG &","NGUYEN,CUONG T &",160000,0,-160000
R290020,"MEHR,JAMSHID TR &","MEHR,JAMSHID",160000,0,-160000
R565972,INFINITY PROPERTIES LLC,INFINITY PROPERTIES LLC &,160000,0,-160000
R308425,SKORO BROTHERS HOMES LLC,SKORO BROS HOMES LLC,160100,0,-160100
R271644,"TRAVER,JEFFERY",HORIZON MANAGEMENT GROUP LLC,160100,0,-160100
R102341,"JOHNSON,KATHRYN S-1/2 &","GILLES,JOANN &",450000,289687,-160313
R258821,"BARRON,BRETT &","BARRON,BRETT &",161000,0,-161000
R251642,"LIBBY,WILLIAM L &","LIBBY,WILLIAM L TR",161000,0,-161000
R251642,"LIBBY,WILLIAM L &",Sale In Progress,161000,0,-161000
R268699,"ANDERSON,KAREN E","DAPP,BRIAN",161000,0,-161000
R331327,"SHEPARD,AMOS","PALMER,BRANDON",161500,0,-161500
R331327,"SHEPARD,AMOS","SHEPARD,CHRIS",161500,0,-161500
R125000,"BROADBECK,JERRI L","BROADBECK,JERRI L TR",162000,0,-162000
R572936,TEAM CAPITAL & INVESTMENT,TRITALENT FUNDING GROUP LLC,162500,0,-162500
R228771,"LESTER,STANLEY D","LESTER,ALICE J",162500,0,-162500
R146502,"THOMPSON,LOLETA &",LEONARD STREET DEVELOPMENT LLC,162500,0,-162500
R289402,"HAWKEY,DAN",THE RW FULLERTON COMPANY,163600,1,-163599
R307298,4905 NE 42ND LLC,"RADFORD,MARK",164550,0,-164550
R122609,RP & ASSOCIATES,"PALAZZO,RANDALL A",164900,0,-164900
R216859,"SAUCEDO,SILVIA E ET AL","SAUCEDO,SILVIA E &",164900,0,-164900
R206452,"DOAN,MAI",AP PACIFIC LLC,165000,10,-164990
R216067,"FREIBERT,GEORGE J TR &","FREIBERT,MARY K",165000,1,-164999
R263664,"KIRK,MICHAEL",LUCI CORPORATION,165000,0,-165000
R186361,"SOMERA,LARRY J","SOMERA,LARRY J &",165000,0,-165000
R178732,"NGUYEN,KHAM","NGUYEN,KHAM Q &",165000,0,-165000
R291972,"CLEMMENS,DENNIS R &","CLEMMENS,DENNIS R &",165000,0,-165000
R291972,"CLEMMENS,DENNIS R &",Sale In Progress,165000,0,-165000
R145172,"DIETER,E PHILLIP &","DIETER,PHILLIP TR &",165000,0,-165000
R194580,"ARTHURS,CAROLE D",ILMDLA LLC,165000,0,-165000
R653120,"SKORO,MATE",SKORO HOMES LLC,166300,0,-166300
R278808,"HAMLIN,VIRGIL L JR &",VIRGIL L & DOROTHY M HAMLIN,166831,0,-166831
R544107,"LYTLE,STEVEN J &","WILKINSON,GAVIN B",1207000,1040000,-167000
R179432,"LUCHINI,ALBERT A JR &","LUCHINI,ALBERT A JR TR &",167000,0,-167000
R110730,"SPANOS,JESSICA &","SPANOS,JON &",167000,0,-167000
R162005,"RUDD,SHARON K &","RUDD,ROBERT C TR &",167250,0,-167250
R209945,OTTY PROPERTIES LLC,"MARKER,CARL W",167750,0,-167750
R184626,"FARHADI,MARIKA",LOUETTA ASSET MANAGEMENT LLC,167900,10,-167890
R190949,"BAIRD,CHRIS",ENCORE DEVELOPMENT,168625,0,-168625
R130806,"STROM,THAI","STROM,THAI NGUYEN TR",169700,0,-169700
R221837,"EDGERTON,ERIK","EDGERTON,ERIK &",170000,0,-170000
R244290,"WANG,DING DING","YANG,SHUANGXI",170000,0,-170000
R276024,"SHEPARD,CHRIS","FARIS,STUART",170000,0,-170000
R292201,"KINDSCHUH,WILLIAM &","LAMBERT,JOE ET AL",170000,0,-170000
R272350,"NERENBERG,DONALD",BERG NORTHWEST LLC,170000,0,-170000
R264124,"CARSON,RONALD A",KS2 PROPERTY LLC,170000,0,-170000
R143131,"RAMIREZ,NANNETTE E","RAMIREZ,GEORGE G TR",170000,0,-170000
R248187,HOMES NEW TO YOU,JJWIN INVESTMENT,170000,0,-170000
R221806,"HENTSCHEL,TYLER B &","HENTSCHEL,BRITTA A",170000,0,-170000
R272919,"BUTZEN,ALAN &","BUTZEN,ALAN E TR &",170000,0,-170000
R297517,"MAHONEY,PATRICK T &","MAHONEY,PATRICK T TR &",170000,0,-170000
R136356,"WEN,PENGCHENG &",Sale In Progress,171000,0,-171000
R249634,"CHAN,HOI",Sale In Progress,171000,0,-171000
R136356,"WEN,PENGCHENG &","WEN,PENGCHENG ET AL",171000,0,-171000
R115128,WILLAMETTE VALLEY,PEF HOMES LLC,172000,0,-172000
R332096,"DO,JOHN-THUONG","DO,JOHN T",172000,0,-172000
R213499,"SHEPARD,AMOS","SHEPARD,AMOS &",196000,24000,-172000
R331761,"PIPGRAS,MARTIN J","PIPGRAS,MARTIN J &",172500,0,-172500
R120997,"POSEY,MARIAN &","POSEY,MARIAN",173000,0,-173000
R305381,"COX,NORMAN &","COX,NORMAN TR &",173073,0,-173073
R107206,"MAXWELL,CALVIN C","MAXWELL,CALVIN C TR",174000,0,-174000
R286989,"GARCIA,REBECCA","GARCIA,REBECCA &",174000,0,-174000
R210557,"BENEDICT,DYLAN B &","CARR,ALLISON J",204000,30000,-174000
R293737,"KRAMER,BRITT","SCHWEIZER,BRITT",174300,0,-174300
R332927,"MAERTZ,ALLEN &","MAERTZ,ALLEN &",349000,174500,-174500
R225805,TEAM CAPITAL &,"HALL,JOSH",174950,0,-174950
R151658,"MEHR,JAMSHID","MEHR,JAMSHID TR &",175000,0,-175000
R261310,"SASAKI,NATHAN","SASAKI,NATHAN &",175000,0,-175000
R114189,"STILWELL,JOHN",ENCORE DEVELOPMENT,175000,0,-175000
R131418,NANCY JANE INVESTMENTS LLC,"HOPKINS,JOHN M",175000,0,-175000
R219600,"LUCIANO,JACQUELINE","LUCIANO,JACQUELINE &",175000,0,-175000
R163656,"IANCU,MARTHA A","IANCU,MARTHA A &",175000,0,-175000
R219764,"EMERSON,JOSEPH A TR &","SCHENCK,BRIAN &",1275000,1100000,-175000
R302738,"ZAGONE,JOHN N &","ZAGONE,JOHN N TR &",175000,0,-175000
R265796,"NGUYEN,TRI MINH","NGUYEN,TRI MINH &",175000,0,-175000
R220302,RP & ASSOCIATES,RP & ASSOCIATES LLC,175000,0,-175000
R292723,"GELBRICH,KEVIN &",GELBRICH LLC,175000,0,-175000
R167639,"BREEDLOVE,JAMES","BREEDLOVE,JAMES-80% &",175000,0,-175000
R173287,"SHEPARD,AMOS &","SCHMITT,TED",175000,0,-175000
R238336,"BAMBECHI,JAY","BAMBECHI,JAY J TR",175000,0,-175000
R234969,"GOUGHNOUR,JERAD &",TTM CAPITAL FUNDING LLC,175000,0,-175000
R152108,"NGUYEN,THAI","NGUYEN,HIEN THAI",175000,0,-175000
R109628,"NGUYEN,THANH","NGUYEN,THANH X",175000,0,-175000
R204974,"HOUSTON,JYNX","SHAHEEN,ROBINA",175000,0,-175000
R291588,"NGUYEN,ANH","NGUYEN,ANH &",175900,0,-175900
R287246,"FARNES,ROBERT",RMCC ENTERPRISES LLC,176000,0,-176000
R213812,"DODSON,JOHN &","PHELPS,JOSHUE P &",177000,0,-177000
R151590,"GILL,BONNIE A &","GILL,BONNIE A",183000,5168,-177832
R210944,"FISH,JEFFREY P",TRILLIUM HOMES LLC,178900,0,-178900
R102457,"CROWELL,KIMBERLY M","CROWELL,KIMBERLY &",179000,0,-179000
R269106,"CROSBY,GAIL","WEBBER,HANNAH &",359000,180000,-179000
R260052,"KRUEGER,TRACY &","KANE,LISA",179000,0,-179000
R631389,"MITCHEL,HELEN B","MITCHEL,HELEN B TR",179000,0,-179000
R312011,"FULLER,PATRICK J","FULLER,PATRICK &",179500,0,-179500
R278954,"DICKSON,MARY &","DICKSON,MARY B TR",179900,0,-179900
R172783,"KNOTTS,CHRIS J &","WYNNE,STEVEN E &",580000,400000,-180000
R161665,"MCGUGAN,MEGAN","MCGUGAN,MEGAN D TR",180000,0,-180000
R270280,"ROBY,JOSEPH III","ROBY,TRACY THANH",380000,200000,-180000
R297709,"RAMEY,DARREN",DKR HOMES LLC,180000,0,-180000
R241792,"LAW,ROBERT M",MAINSTREET DEVELOPMENT INC,180000,0,-180000
R241792,"LAW,ROBERT M",MAINSTREET DEVELOPMENT INC,180000,0,-180000
R282260,"NORRIS,ALISA","NORRIS,ALISA M",180000,0,-180000
R138781,"MATSUDA,ERIN &","HERTIG,DAVID A &",180000,0,-180000
R338779,"HOLENSTEIN,CHRIS",Sale In Progress,180000,0,-180000
R591045,"LE,TOAN QUOC &","LE,NHY PHAN &",180000,0,-180000
R338779,"HOLENSTEIN,CHRIS","HOLENSTEIN,CHRIS TR &",180000,0,-180000
R120310,"NICHOL,SARAH S &","LEE,SARAH N &",180000,0,-180000
R262893,"BANDELOW,JEFFREY &",J2KT PROPERTIES LLC,181000,0,-181000
R337954,"GOOD,KEVIN W &","GOOD,CHERYL L",181000,0,-181000
R120202,"SWINGLE,WENDY &","PATTERSON,ROBERT",181500,0,-181500
R196661,"MEYER,JAMES &","MEYER,JAMES &",182000,0,-182000
R261577,EWCP LTH FUND LLC,EQUITY WEST LTH POOL I LLC,182500,0,-182500
R174075,"WOOD,STEPHEN A",S&G; WOOD LLC,182500,0,-182500
R241917,OREGON FUNDING GROUP LLC,"CORBETT,JIM",183500,0,-183500
R173912,"HESS,HELEN L",FCDB 8020 REO LLC,184900,0,-184900
R173073,"GLENN,GARY &","HUMPHRIES,GARY A &",184900,0,-184900
R314039,OXBOW LLC,"MC KEEL,MIKE L",185000,0,-185000
R250458,UNIVERSITY DEVELOPMENT,UNIVERSITY DEVELOPMENT LLC,185000,0,-185000
R171441,EDEN ENTERPRISES LLC,"WHEELER,TIMOTHY K &",965000,780000,-185000
R151477,PCLT DEVELOPMENT LLC,PROUD GROUND,185000,0,-185000
R289976,"SCHUMACHER,HARRY",SCHUMACHER CUSTOM HOMES INC &,185000,0,-185000
R308796,"OLSON,JOHN",KDO ENTERPRISES LLC,185000,0,-185000
R589323,"LE,TOAN QUOC &","LE,NGUYEN PHAN &",185000,0,-185000
R308796,"OLSON,JOHN",KDO ENTERPRISES LLC,185000,0,-185000
R556903,"FRITZ,THOMAS","FRITZ,THOMAS &",185000,0,-185000
R338604,"COVINGTON,LESTER C",US BANK NATIONAL ASSN TR,360000,175000,-185000
R221108,"ADICOFF,KAREN L &","ADICOFF,KAREN L TR",185000,0,-185000
R102129,"DEMARCO,MICHAEL &","YIM,LUCY",185500,0,-185500
R231872,"SEKERMAN,JILL","SEKERMAN,JILL K TR",185500,0,-185500
R126224,"PACHTER,HILARY","PACHTER,HILARY &",185500,0,-185500
R335930,"JEROMANOVS,MARTS","JEROMANOVS,MARTS &",185850,0,-185850
R220241,"NGUYEN,SANH D &","TRAN,DE T &",186000,0,-186000
R220241,"NGUYEN,SANH D &","NGUYEN,SANH D &",186000,0,-186000
R180192,"CROSBY,ANDREW &",DANDELION PROPERTIES LLC,187000,0,-187000
R521218,"HUYNH,HONG VAN","HUYNH,HONG VAN",187500,0,-187500
R228859,"FEIGION,JENNIFER A","GROSS,JASON &",187500,0,-187500
R102764,"SHULTZ,CHARLES","SHULTZ,CHARLES TR",187550,0,-187550
R130030,"BURNS,DAVID L &","BURNS,DAVID L TR &",188000,0,-188000
R281849,"FLOOD,TOM &","FLOOD,SUZANNE",188000,0,-188000
R281849,"FLOOD,TOM &","FLOOD,SUZANNE",188000,0,-188000
R302063,HARTLEY INVESTMENTS LLC,THREE J'S RENOVATIONS LLC,188535,0,-188535
R107442,"WON,TIMOTHY","LEE,TIMOTHY W W W",188800,0,-188800
R211314,"SIGMUND,V IAN &",SIGMUND INVESTMENT,189000,0,-189000
R199013,LAFERRIERE FAMILY REAL EST LLC,"LAFERRIERE,DANIEL S &",189000,0,-189000
R274342,"PERSAUD,GLORIA J &","PERSAUD,RANJEET",189500,0,-189500
R277564,AMERICAN HOMES 4 RENT,AMH 2014-2 BORROWER LLC,189500,0,-189500
R515575,"ALLEN,BETTY F","ALLEN,BETTY MAY F TR",189900,0,-189900
R336141,"FOX,JOHN M",SNYDER CONSTRUCTION LLC,189990,0,-189990
R201273,"THAN,PHUONG &","THAN,PHUONG",190000,0,-190000
R531632,"ZOOK,RONALD Z &","ZOOK,RONALD Z TR-1/2 &",190000,0,-190000
R300733,"RAZE,STEPHEN M",RARO LLC,190000,0,-190000
R277077,"EDMONDSON,STEVEN &",S&J; ASSOCIATES LLC,190000,0,-190000
R311668,"ROGERS,DAVID A",CENTRUM URBAN DEVELOPMENT LLC,190000,0,-190000
R127262,"ALI,MUNA ABBAS","AHMED,ABDELAAL HASSAN",190000,0,-190000
R108058,"SKORO,ANTE V","SKORO,ANTE V TR &",190000,0,-190000
R302346,"BAMBECHI,JAY","BAMBECHI,JAVAD",190000,0,-190000
R154037,GEZA DEVELOPMENT LLC,CLUNAS FUNDING GROUP INC,190000,0,-190000
R271869,"ALVAREZ,MAURICIO",ALVAREZ PROPERTIES LLC,190000,0,-190000
R135186,"COLE,PHILIP V &","COLE,PHILIP V TR &",190000,0,-190000
R161705,"PHU,TAI","PHU,TAI QUOC &",190000,0,-190000
R163573,"GILES,ELIZABETH S &","RUBADO,ELIZABETH S &",190000,0,-190000
R230449,"MCGINTY,LYNN &",ROCKY BUTTE LLC,190500,0,-190500
R281674,"DULLINGER-FRY,CAALON A &","DULLINGER-FRY,CAALON A &",191000,0,-191000
R193937,"ABRAHAM,PHILIP T SR &","ABRAHAM,PATRICIA J",191000,0,-191000
R106890,"BARRON,KAM &","GOSTOMSKI,MICHAEL",191900,0,-191900
R573632,"RUANO,ERICK GIOVANNI C","DIAZ,VIVIAN TR",192000,0,-192000
R181466,"KIRK,MICHAEL R",LUCI CORPORATION,192000,0,-192000
R242882,"MCCUEN,KENNETH &","MCCUEN,KENNETH &",192500,0,-192500
R290916,BARNABAS REAL ESTATE GROUP LLC,BARNABAS REAL ESTATE GROUP LLC,192500,0,-192500
R114311,"EASTON,KREY &","EASTON,KREY",193000,0,-193000
R547343,AMERICAN HOMES 4 RENT,AMH 2014-2 BORROWER LLC,193000,0,-193000
R163152,"ORTIZ,GLORIA P","ORTIZ,GLORIA P &",193000,0,-193000
R220729,"PEACOCK,JAMES","PEACOCK,JAMES &",193000,0,-193000
R295618,"COLE,MEREDITH A &","THILL,MATTHEW TR",193000,0,-193000
R108362,"SCHUCK,JONATHAN W TR &","SCHUCK,JONATHAN W &",193025,0,-193025
R138840,"MCALPIN,TIMOTHY C","MCALPIN,TIMOTHY C TR",193500,0,-193500
R108539,"CHAN,YIM SUN","CHAN,YIM SUN",195000,0,-195000
R245314,"SINGLETON,WILLIAM R",Sale In Progress,195000,0,-195000
R108539,"CHAN,YIM SUN",UNITED STATES OF AMERICA,195000,0,-195000
R290433,TEAM CAPITAL & INVESTMENT,"HALL,JOSHUA",195000,0,-195000
R205679,"SHOTWELL,GILBERT &","SHOTWELL,GILBERT L TR &",195000,0,-195000
R158851,"HULBERT,COURTNEY &","BLOOMQUIST,IVAN",195000,0,-195000
R261955,"MAGNUSON,DELORES J &","HARVEY,BONNIE L",195000,0,-195000
R245314,"SINGLETON,WILLIAM R","SINGLETON,WILLIAM R &",195000,0,-195000
R135996,"SCHWARTZKOPH,HENRY &","SCHWARTZKOPH,MARION",195000,0,-195000
R285615,"SKORO,ANTE",SKORO BROS HOMES LLC,195000,0,-195000
R109734,"GRAY,JAMES W",B-W CONSTRUCTION INC,195000,0,-195000
R225325,"GILLESPIE,DUANE L &","GILLESPIE,DEBRA L",196000,0,-196000
R135278,"ROTHERY,KENNETH F &","ROTHERY,KENNETH F",196000,0,-196000
R197956,"COUCH,DANIEL","COUCH,DANIEL &",196500,0,-196500
R167203,EASTSIDE EQUITIES LLC,"BUTLER,DANIEL R TR",197000,0,-197000
R168419,"SCHUMACHER,JOHN &","SCHUMACHER,JOSEF P &",197500,0,-197500
R284824,"LANGFORD,ANNE","URQUIZA,MARK &",197500,0,-197500
R175269,"MCCLUER,SCOTT E &","MCCLUER,SCOTT E",198000,0,-198000
R109702,"SAECHAO,LOU F &","SAECHAO,VARN TSOY",198000,0,-198000
R210537,"ISAACSON,ERIC B &","SCHOLZ,LAURA A",242000,43500,-198500
R136512,GREENWING RESTORATIONS LLC,LHI REAL ESTATE INC,198800,0,-198800
R154689,"HUETHER,ADRIAN ET AL",HOOD VIEW INVESTMENTS LLC,199000,0,-199000
R206032,"DEMOY,ROGER W TR &","DEMOY,ROGER W &",199000,0,-199000
R176627,"SMITH,CARL &",SUNNYSIDE INVESTMENTS LLC,199500,0,-199500
R135534,"ROH,JERRY L &","ROH,JERRY L",199900,0,-199900
R300655,"EDWARDS,CHARLES IV","EDWARDS,CHARLES IV &",199900,0,-199900
R136070,"JOHNSTON,W W &","JOHNSTON,W W TR &",199900,0,-199900
R116915,"MCKAY,DEAN E TR","MCKAY,DEAN E TR",200000,0,-200000
R159007,"RODDAN,LEA ANN",STERLING RESIDENTIAL LLC,200000,0,-200000
R211917,"KATZ,LORIN R &",SE 42ND LLC,200000,0,-200000
R125129,"SHEEHAN,LAUREN",M & S CONSTRUCTION LLC,200000,0,-200000
R180592,"KIM,KIHWANG","CASPER,BRYAN K &",1400000,1200000,-200000
R269104,"SURPRENANT,ANNMARIE","SURPRENANT,ANNMARIE &",200000,0,-200000
R299031,"BECK,ETHAN &",K STREET PROPERTY LLC,200000,0,-200000
R272830,"WHITMORE,DONNA L","WHITMORE,DONNA L &",200000,0,-200000
R299031,"BECK,ETHAN &",K STREET PROPERTY LLC,200000,0,-200000
R229818,"STREBIN,GREGORY B &","STREBIN,GREGORY B TR &",200000,0,-200000
R148717,"FLORES,JESUS S &","FLORES,GUADALUPE A",200000,0,-200000
R167658,"MAZURIK,GEORGE","MAZURIK,GEORGE",200000,0,-200000
R148717,"FLORES,JESUS S &","FLORES,JESUS S &",200000,0,-200000
R639883,"KNUTZEN,THEODORE &","KNUTZEN,THEODORE &",200000,0,-200000
R298205,"SCHUMACHER,HARRY A &","SCHUMACHER,SHERYL L",200000,0,-200000
R157396,"SCANLON,THOMAS J &","SCANLON,THOMAS J TR-1/2 &",200900,0,-200900
R148201,"BROWN,STEPHEN A","BROWN,STEPHEN A &",399000,197975,-201025
R206349,"HOLROYD,DRINDA L &","HOLROYD,DRINDA L &",202000,0,-202000
R213300,AMERICAN HOMES 4 RENT,AMH 2014-2 BORROWER LLC,202000,0,-202000
R124835,"BURGESS,JEFFREY E","BURGESS,JEFFREY E &",204000,0,-204000
R212373,"SUSSMAN,MARC &","SUSSMAN,MARC TR &",205000,0,-205000
R332097,"TRAHAN,ELLEN &","TRAHAN,ELLEN",205000,0,-205000
R306922,"ANDERTON,KEN &","ANDERTON,KENNETH",205000,0,-205000
R115840,SIDERAS CONSTRUCTION,SIDERAS VENTURES LLC,205000,0,-205000
R226189,"VASILE,ADRIAN &",OVERLOOK CENTRAL GROUP LLC,205000,0,-205000
R278838,"SMITH,VIRGINIA M","SMITH,VIRGINIA M TR",205000,0,-205000
R236506,"STEHMAN,LARRY C &","STEHMAN,LEILA F",205000,0,-205000
R160001,RP & ASSOCIATES LLC,"PALAZZO,RANDALL A",205000,0,-205000
R224719,"COLE,CLIFFORD L &","COLE,CLIFFORD L TR &",205000,0,-205000
R209329,"PREDESCU,CLAUDIU &","TUREAC,DUMITRU &",205000,0,-205000
R252284,"WARD,WINIFRED R H &","WARD,BYRON A",205000,0,-205000
R165676,MARKS CUSTOM EXTERIORS INC,"HOLCOMB,MARCUS R",205025,0,-205025
R249291,"DORAN,YVONNE C","DORAN,YVONNE TR",206000,0,-206000
R221226,"FARNES,ROBERT",RMCC ENTERPRISES LLC,206725,0,-206725
R280266,"HOLDER,ROBERTA","HOLDER,ROBERTA L TR",207000,0,-207000
R258612,"CASSARINO,ANITA &","CARBONI,STEVEN A TR &",207000,0,-207000
R162805,"VER MEER,DON &","VERMEER,DONALD &",208000,0,-208000
R235285,"ANTONIO,GIDEY &","ARAYA,ALAZAR &",208000,0,-208000
R130025,"KAFOUROS,GEORGE","KAFOUROS,GEORGE &",208000,0,-208000
R120115,"DE BRUIN,CHARLENE &","DEBRUIN,CHARLENE J TR &",209000,0,-209000
R132187,"KNIGGE,DONALD R","KNIGGE,DONALD R &",209000,0,-209000
R311642,RGB BUILDINGS INC,"BRAEM,RICHARD G",209000,0,-209000
R206390,"WESTWOOD,WAYNE W",WESTWOOD INVESTMENT LLC,209500,0,-209500
R186440,"HWOSCHINSKY,PAUL &",5261 NE 29TH AVENUE LLC,210000,0,-210000
R301942,"MALABANAN,JESSICA &","BELSHAW,JESSICA R",210000,0,-210000
R261505,"VALENTINE,NATHAN","VALENTINE,NATHAN E &",210000,0,-210000
R325166,"HASHEM,SOFIA A","RAY,STEPHEN G",715000,505000,-210000
R494286,"BERGER,WAYNE H &","BERGER,WAYNE TR &",210000,0,-210000
R252935,"WATKINS,JESSICA L &","WATKINS,JESSICA L",210000,0,-210000
R325166,"HASHEM,SOFIA A","RAY,STEPHEN G",715000,505000,-210000
R313725,"TOWLE,ROBERT","TOWLE,ROBERT D TR",210000,0,-210000
R309361,"MARTORANA,ANGELIA &",ROSEBIRD LLC,210000,0,-210000
R207342,"YUN,THOMAS R","YUN,NANCY",210000,0,-210000
R107735,"BERNSTEIN,ALBERT J &","BERNSTEIN,ALBERT J TR &",210000,0,-210000
R593610,"MARTIN,SARAH","MARTIN,SARAH A TR",210000,0,-210000
R143678,"BORZOSH,SEBASTIAN","BORZOSH,SEBASTIAN &",210000,0,-210000
R215579,"JIANG,YAN PING","JIANG,YAN PING &",210200,0,-210200
R215579,"JIANG,YAN PING","JIANG,YAN PING &",210200,0,-210200
R199186,U S BANK NA TR,"BULLARD,MARY",210990,0,-210990
R593548,"BARNES,JOHN R JR","GILMORE,STEVEN M &",211000,0,-211000
R150932,"JONES,AARON M",MCKENNON HOLDINGS LLC,211000,0,-211000
R276808,"BENTON,VERNON A TR &","BENTON,LILLIAN H TR",211825,0,-211825
R276225,"MERRIHEW,TUCKER",TTM DEVELOPMENT COMPANY,212000,0,-212000
R313564,"DE BRUIN,SIMON &","DEBRUIN,CHARLENE J TR &",212000,0,-212000
R247191,"SCHLECHTER,SCOTT &","MALLIRIS,BRIAN H ET AL",212000,0,-212000
R529980,"WARD,CLAYTON","WARD,CLAYTON &",212000,0,-212000
R186387,RIVERMARK COMMUNITY CREDIT,WILLAMETTE VALLEY,212000,0,-212000
R276786,"BURCHFIELD,KATHERINE A","BURCHFIELD,KATHERINE A TR",212500,0,-212500
R220196,"THORNHILL,FREDRICK G","THORNHILL,FREDRICK G &",212500,0,-212500
R218998,"SCHNEIDER,GUNTER &","SCHNEIDER,HELGA",213000,0,-213000
R221620,"WILLIAMS,THOMAS V TR &","WILLIAMS,THOMAS V TR &",213000,0,-213000
R119522,CHALET HOMES LLC,AAV ONE LLC,213600,0,-213600
R130793,"FILARDO,JOE P &","FILARDO,JOSEPH P &",214000,0,-214000
R138434,"DEGOEDE,MARYANNE F &","DEGOEDE,MARYANNE F TR",214000,0,-214000
R185475,"ZEMP,MARCEL A",ZEMP INVESTMENTS LLC,214000,0,-214000
R136869,"WEATHERFORD,JONATHAN","PUGH,MARY E &",214000,0,-214000
R290096,WEST COAST REAL ESTATE,NORTHWEST CAPITAL FUNDING,214300,0,-214300
R238941,"BAUER,PAUL D TR","MEEHAN,CRYSTAL",214500,0,-214500
R180298,"KINNAN,CHRISTINA","CROOKS,CHRISTINA",215000,0,-215000
R127191,"JOHNSON,RALPH H &","JOHNSON,ESTHER I",215000,0,-215000
R297919,"HOWLETT,DANIEL","HOWLETT,DANIEL L",215000,0,-215000
R180298,"KINNAN,CHRISTINA","CROOKS,CHRISTINA",215000,0,-215000
R277181,"LAWRENCE,ROBERT","LAWRENCE,ROBERT &",215000,0,-215000
R181180,"PETRUSHA,YURIY V &",RUYTEP LLC,215000,0,-215000
R137309,"BANNISTER,AARON C &","BANNISTER,AARON",215000,0,-215000
R217783,"GRANT,PETER","GRANT,PETER K &",215000,0,-215000
R139916,"FARMER,MERRY L","FARMER,MERRY L TR",215000,0,-215000
R591164,"PRUSIA,CHRISTIAN &",PRUSIA PROPERTIES LLC,215900,0,-215900
R499864,"VALIN,REGGIE D","VALIN,REGGIE D &",216000,0,-216000
R119343,"GESKE,PAUL",DLG INC,217000,0,-217000
R144874,"RUVO,TIMOTHY W TR-50% &","RUVO,CAROL M TR",217000,0,-217000
R255717,"JOHNSON,COLLEEN R &","JOHNSON,COLLEEN R",218000,0,-218000
R651690,AAV ONE LLC,"BARNHART,LARRY",340000,122000,-218000
R291067,"ALLEN,ANGELA","ALLEN,ANGELA &",371700,153326,-218374
R133443,PROPERTY QUEST LLC,JCDC HOLDING COMPANY LLC,218400,0,-218400
R155843,"NIMZ,MARK T",Sale In Progress,219450,0,-219450
R155843,"NIMZ,MARK T","NIMZ,MARK T &",219450,0,-219450
R334701,"ABBASSI,HANRY &","HUGHES,MICHAEL",219473,0,-219473
R254600,JET INVESTMENTS LLC,"BULLOCK,KRISTINA M",219659,0,-219659
R269274,"GARNER,VIVIAN J &","GARNER,VIVIAN J &",219900,0,-219900
R165173,"TEWARI,DEVANSU &","SHAW,KEVIN X &",749000,529000,-220000
R241620,"MEYER,GRETCHEN TR","MEYER,GRETCHEN A",220000,0,-220000
R173938,"KIRK,MICHAEL &","KIRK,MICHAEL",220000,0,-220000
R211311,"HENDRICKS,AMANDA A","HENDRICKS,AMANDA A &",220000,0,-220000
R557692,"SHOWALTER,JUDITH &","SHOWALTER,JUDITH",220000,0,-220000
R231943,"LIPKIND,JOSEPH","LIPKIND,JOSEPH H TR",220000,0,-220000
R125417,"MEAKINS,DEBORAH L &","MEAKINS,DEBORAH L",220000,0,-220000
R332042,"PHAM,KIM XUYEN THI","PHAM,KIM XUYEN THI &",220000,0,-220000
R324516,"JIA,YIBING","JIA,YIBING &",220000,0,-220000
R277827,AMERICAN HOMES 4 RENT,AMH 2014-2 BORROWER LLC,220000,0,-220000
R317399,"GIBSON,CHARLES",KILLINGSWORTH HOUSE LLC,220600,10,-220590
R551098,"BANKER,THOMAS &",POLK STREET LLC,222000,0,-222000
R279119,"HAMMOND,CAROLYN M","HAMMOND,CAROLYN M TR",222000,0,-222000
R211543,URBAN HOUSING DEVELOPMENT LLC,RODNEY PLACE LLC,222000,0,-222000
R154566,"MONSON,SUSAN E &","MURPHY,JAMES F &",223000,0,-223000
R138409,"ERICKSON,KATHERINE S &","ERICKSON,KATHERINE S &",223000,0,-223000
R224991,"MONNES,RANDAL J &",MONNES HOLDINGS LLC,223200,0,-223200
R302456,"ZAGONE,JOHN N &","ZAGONE,JOHN N TR &",223500,0,-223500
R328080,"HINRICHS,JAY",JADEE LLC,223790,0,-223790
R297358,"RODRIGUEZ,ARIEL A &",FEDERAL NATIONAL MORTGAGE,224000,0,-224000
R575210,"SAYRES,PHILIP C JR &","SAYRES,AURELIE I",224000,0,-224000
R123672,"LUCK,SUSANNA E &","LUCK,SUSANNA E",240000,15210,-224790
R265098,"CAVETTE,SUZANNE","CAVETTE,SUZANNE TR",224950,0,-224950
R265098,"CAVETTE,SUZANNE","CAVETTE,SUZANNE TR",224950,0,-224950
R292415,"JOYCE,GREGORY","JOYCE,GREGORY &",224950,0,-224950
R190622,RP & ASSOCIATES,RP & ASSOCIATES LLC,225000,0,-225000
R294913,"DISCIASCIO,KAREN E &",JAKE & SNOOKER LLC,225000,0,-225000
R133902,"LE,NAM VAN &","LE,MELISSA P",225000,0,-225000
R133230,"SCHLOSSBERG,JOHN B II TR","SCHLOSSBERG,JOHN B II TR",225000,0,-225000
R587875,"COOLEY,CHERI D","COOLEY,CHERI D",225000,0,-225000
R303506,"VOGEL,SAMUEL D &","VOGEL,MELANIE L",225000,0,-225000
R160958,"RAZE,JIM &",RAZE CUSTOM HOMES INC,225000,0,-225000
R274868,"PERRY,JONATHON N","PERRY,JONATHON N &",225000,0,-225000
R252222,"MCCOWEN,GEORGE JR &","MCCOWEN,GEORGE S JR TR &",225000,0,-225000
R123238,EVERETT CUSTOM HOMES,PARAGON DEVELOPMENT LLC,725000,500000,-225000
R172995,"KIRK,MICHAEL",LUCI CORPORATION,225000,0,-225000
R136299,"CERCEA,DUMITRU JR","CERCEA,DUMITRU JR &",225000,0,-225000
R558928,"MARTINEZ,SIGFREDO M",MARTINEZ NAMASTE II LLC,225500,0,-225500
R179568,"MICHAELSEN,JEAN","MICHAELSEN,KELLY S",226500,1000,-225500
R291388,"WOLLAM,CATHERINE &","WYTCHERLEY,GREGORY",225800,0,-225800
R589322,"EASTBOURNE,BARBARA","EASTBOURNE,BARBARA A TR &",226000,0,-226000
R173796,"METZGER,KYLE A &","METZGER,KYLE",227000,0,-227000
R131948,"NGUYEN,VU D &","NGUYEN,VU &",227000,0,-227000
R130159,"MURPHY,JOYCE","MURPHY,JOYCE &",227000,0,-227000
R278909,"AIKEN,NATALIE K &",AIKEN FAMILY TRUST,227950,0,-227950
R142141,"BECKER,THOMAS A &","BECKER,THOMAS A TR &",228460,0,-228460
R209701,"HOLLEY,PAULETTE TR","HOLLEY,PAULETTE TR",228500,0,-228500
R607336,"BROWN,ELIZABETH L","BROWN,ELIZABETH L TR",229000,0,-229000
R170971,"GRAY,MARION &","GRAY,SHIRLEY",229000,0,-229000
R261057,"JONES,MARY J","JONES,MARY J TR",229000,0,-229000
R228859,"AGNESSE,PHILIPPE",P & R INVESTMENT GROUP LLC,229000,0,-229000
R242116,"SCHWAIGER,AMBER R","JOHNSON,AMBER R",229000,0,-229000
R226790,"ADAMS,DENNIS &","ADAMS,DENNIS &",229167,0,-229167
R113625,"MILLER,JOYCE E","MILLER,JOYCE E TR",229900,0,-229900
R547596,AMERICAN HOMES 4 RENT,AMH 2014-2 BORROWER LLC,229900,0,-229900
R279455,"NAIDITCH,WILLIAM P &","NAIDITCH,WILLIAM P &",230000,0,-230000
R294254,"ROBERTSON,JAMES","ROBERTSON,JAMES &",230000,0,-230000
R201027,AMERICAN HOMES 4 RENT,AMH 2014-2 BORROWER LLC,230000,0,-230000
R328862,"CHAPMAN,RICHARD","CHAPMAN,RICHARD &",230000,0,-230000
R231719,CITY BAKING COMPANY &,CITY BAKING COMPANY &,230000,0,-230000
R254872,"PHILLIPS,GORDON B","PHILLIPS,GORDON B TR",230000,0,-230000
R229961,"STREBIN,GREGORY B &","STREBIN,GREGORY B TR &",230000,0,-230000
R127925,"WRIGHT,MARK S ET AL",NINTH AVE RENTAL LLC,230000,0,-230000
R137218,PALAZZO CUSTOM HOMES LLC,RP & ASSOCIATES LLC,230000,0,-230000
R279066,"WALKER,BRUCE &","WALKER,BRUCE M TR &",230000,0,-230000
R103811,"NOLD,LYLE M &","NOLD,ESTHER M",230500,0,-230500
R556969,"RILEY,DIONSAI","RILEY,DIONSAI K",231000,0,-231000
R320605,"MAXWELL,CALVIN C","MAXWELL,CALVIN C TR",231000,0,-231000
R163611,"WILSON,H WILLIAM &","WILSON,JOYCE E",231500,0,-231500
R298601,BASTACKY-HOCKENHEIMER,"HOCKLEY,CLIFF A &",231500,0,-231500
R278995,"HOWARD,INEZ M","HOWARD,INEZ M TR",233000,0,-233000
R165845,"PAGUIO,ARISTOTLE &",SENIOR HAVEN RESIDENTIAL,233000,0,-233000
R279557,"AUFFET,KIMBERLY K","BARKER,KIMBERLY K &",233000,0,-233000
R304312,"HIMEL,JOSH &","HIMEL,JOSH TR-1/2 &",233905,0,-233905
R264428,DILUSSO HOMES LLC,DILUSSO HOMES LLC &,234000,0,-234000
R147598,"ANDERL,LISA C &","MCKEE,LISA C &",234900,0,-234900
R489763,"SMITH,WILLIAM R &","SMITH,SHANNON M",234900,0,-234900
R268876,HEREFORD CONSTRUCTION CO INC,MORE GREEN RESTORATIONS LLC,235000,0,-235000
R173765,"WANG,HUI","WANG,HUI &",235000,0,-235000
R326432,DREAMWORKS DEVELOPMENT INC,"HOLCOMBE,DELTON A II &",235000,0,-235000
R125858,"HILLS,DOUG","HILLS,DOUGLAS W &",235000,0,-235000
R106591,"JENSEN,KENNETH N","JENSEN,KENNETH N TR &",235000,0,-235000
R266855,"NOLLENBERGER,LARRY","NOLLENBERGER,LAWRENCE P TR &",235000,0,-235000
R225020,PIERCE INVESTMENT PROPERTIES,PACIFIC CONTINENTAL BANK,235000,0,-235000
R547865,AMERICAN HOMES 4 RENT,AMH 2014-2 BORROWER LLC,235000,0,-235000
R207467,LIBERTY HOMES NW LLC,LIBERTY NW HOMES LLC &,236000,0,-236000
R288465,"WILSON,JAY","ERICKSON,STEVEN",562000,325000,-237000
R201787,"LE,PHAN &","NGUYEN,TAN T &",237000,0,-237000
R157590,"BARTELL,ELIZABETH","BARTELL,ELIZABETH TR",237500,0,-237500
R560002,MARTEL INVESTMENTS LLC,"LYMAN,MATTHEW &",238000,0,-238000
R224635,WOOD MILL COURT,"WOOD,LAWRENCE D &",238997,0,-238997
R228781,CHIMUKU MECHANICAL LLC,CHIMUKU MECHANICAL LLC &,239000,0,-239000
R244384,"LUI,KUO CHIH &","LIU,KUO CHIH &",239000,0,-239000
R161980,"SILVER,ERIKA","SILVER,ERIKA TR",239900,0,-239900
R206412,DOZER CONSTRUCTION LLC &,RIVERWOOD NW PROPERTIES LLC,239900,0,-239900
R119624,"JELLISON,STEVEN B &","JELLISON,STEVEN B &",239900,0,-239900
R206412,DOZER CONSTRUCTION LLC &,RIVERWOOD NW PROPERTIES LLC,239900,0,-239900
R132637,"PIERCE,MARVIN L &","PIERCE,MARVIN L &",240000,0,-240000
R126968,"CAMERON,KALE &","CAMERON,KALE M",240000,0,-240000
R241655,RP & ASSOCIATES,RP & ASSOCIATES LLC,240000,0,-240000
R132637,"PIERCE,MARVIN L &","PIERCE,MARVIN L &",240000,0,-240000
R307015,"HITCHCOCK,DARCY &",HITCHCOCK GRAHAM INVESTMENT,240000,0,-240000
R333577,"ANDREWS,PHILIP J &",BETH-GADER LLC,240000,0,-240000
R272394,"APP,RICHARD J &","APP,RICHARD J",240000,0,-240000
R278927,"COULTER,CHARLES R &","COULTER,CHARLES R TR - 50% &",240000,0,-240000
R205029,RENAISSANCE CUSTOM HOMES LLC,RENAISSANCE DEVELOPMENT,240000,0,-240000
R309611,"KOVAL,ALEKSANDER",CLASSIC IMAGE HOMES LLC,240000,0,-240000
R135042,"NGO,HUNG K &","NGO,HUNG K &",241000,0,-241000
R161241,"HICKS,CAROL J","HICKS,CAROL J TR",241000,0,-241000
R126397,"BETTLES,BYRON &",Sale In Progress,242000,0,-242000
R126397,"BETTLES,BYRON &","BETTLES,BYRON &",242000,0,-242000
R264284,"BAIN,ROBERT &","BAIN,ROBERT S JR TR-1/2 &",242000,0,-242000
R266669,"ROWLAND,MILTON E &","ROWLAND,MILTON E",242000,0,-242000
R133421,PIERCE INVESTMENTS LLC,PACIFIC CONTINENTAL BANK,242500,0,-242500
R294618,"ELISSAGARAY,ANNA E","ELISSAGARAY,ANNA TR",242500,0,-242500
R110280,"GALVAN,JUANA R","HERNANDEZ VILLA,JOSE L &",243500,0,-243500
R214114,"TUPPER,HENRY C &","TUPPER,HENRY CLAY &",244000,0,-244000
R172294,"PHILLIPS,HARRIET S","SHERIDAN,HARRIET",244100,0,-244100
R270292,"EMMICH,ROBERT &","EMMICH,NAOMI",245000,0,-245000
R139136,"GILBERT-READ,PAT","GILBERT-READ,PAT EST OF",245000,0,-245000
R154153,"MERRIHEW,TUCKER",TTM DEVELOPMENT COMPANY,245000,0,-245000
R502646,"JENSEN,WILLIAM H &","ESHRAGH,VAHID T",1170000,925000,-245000
R318873,"SHABAZZ,ABDUL BASIR","CLARK,OTIS W",245000,0,-245000
R241695,"DE SANTIS,JILL B","DE SANTIS,DEAN B &",245000,0,-245000
R323152,WAYNE STONE LOGGING INC,THE PEOPLE'S FARM LLC,615000,370000,-245000
R269190,LUCKY DAN LLC,"LACHENMEIER,DANNY",245000,0,-245000
R133307,"GAGE,ZACHARY","BARBOUR,JULIE &",245000,0,-245000
R283197,"KALIN,ALEX",Sale In Progress,245600,0,-245600
R148529,"FISCHER,TED O JR &","FISCHER,TED O JR, TR &",246000,0,-246000
R329078,"YODER,CHRISTIAN G &",Sale In Progress,246000,0,-246000
R329078,"YODER,CHRISTIAN G &","YODER,CHRISTIAN G",246000,0,-246000
R118108,"HENRIKSON,RONALD J &","HENRIKSON,MARGARET A",246700,0,-246700
R278926,"YUDT,HENRY J &","YUDT,HENRY J TR &",247000,0,-247000
R254774,"BIDSTRUP,FREDE &","BIDSTRUP,JOAN I",247000,0,-247000
R577479,"VARGAS,MARIA","VARGAS,FRANCISCO J &",247000,0,-247000
R166865,"KAIB,JOHN &","BARR,SHEROLD B",247120,0,-247120
R188685,"MAY,BEN",JONAY PROPERTIES LLC,248000,0,-248000
R269118,"FETTERS,REBECCA L TR &","FETTERS,KENNETH A &",248000,0,-248000
R619460,"BULLOCK,LARRY &","BULLOCK,LARRY A TR &",248000,0,-248000
R185851,"ERICSON,CRAIG","ERICSON,CRAIG H TR",249000,0,-249000
R144988,"TUROWSKI,MICHAEL E &","TUROWSKI,MICHAEL E",249000,0,-249000
R238152,"NOONBERG,RICHARD","NOONBERG,RICHARD &",249500,0,-249500
R144309,"TURNAGE,RICHARD &","TURNAGE,ELLA",249900,0,-249900
R138302,"IERULLI,FRANK M &","IERULLI,MARY BETH",249900,0,-249900
R154920,"PIERONI,CRYSTAL &","LANGE,BARRY M &",249900,0,-249900
R272017,"ATKINSON,WILSON L &","ATKINSON,WILSON L",249900,0,-249900
R102288,"ZIMMERMANN,NANCY A","ZIMMERMANN,NANCY A &",250000,0,-250000
R539660,"WEST,MARIE A",Sale In Progress,250000,0,-250000
R151512,"DRESSELHAUS,JAMIE A &","DRESSELHAUS,JAMIE A",250000,0,-250000
R222455,RP & ASSOCIATES LLC,CLUNAS FUNDING GROUP INC,250000,0,-250000
R232336,"PAJARI,THOMAS S","PAJARI,EARL A &",250000,0,-250000
R132108,"HOLLEN,JOYCE","EMERY,RANDALL N &",250000,0,-250000
R134661,"APPLETON,MICHAEL &","APPLETON,MICHAEL S &",250000,0,-250000
R130446,"MENG,DONNA L","MENG,DONNA L TR",250000,0,-250000
R326517,"HORNER,RODRICK",WYNDYM DEVELOPMENT LLC,250000,0,-250000
R183077,"WEAVER,ERNEST C","MITCHELL,B J",250000,0,-250000
R124838,"HUTCHINSON,EILEEN R",STARBOARD HOMES LLC &,250000,0,-250000
R276212,"NELSON,KAREN &","TEMPLE,MARY",275000,24830,-250170
R293155,"SCHLOSSER,LAMARC &","SCHLOSSER,LAMARC A &",250300,0,-250300
R199635,"WAGNER,JOHN F &","WAGNER,JOHN F TR &",250500,0,-250500
R221995,"CHACARTEGUI,JOHN &","CHACARTEGUI,DOROTHY N",251000,0,-251000
R154820,"CAHILL,KENNETH D","CAHILL,KENNETH D &",251000,0,-251000
R104140,"FARNES,ROBERT",RMCC ENTERPRISES LLC,251099,0,-251099
R276275,"IVY,PATRICIA","IVY,ROBERT M TR",251900,0,-251900
R223498,DILUSSO HOMES LLC 2/3 &,"DANIEL,DAVID R &",750000,498000,-252000
R279011,"MEAD,JUDY A","MEAD,JUDY A TR",252500,0,-252500
R186992,"YAMADA,RUSSELL S &","YAMADA,RUSSELL S TR &",252500,0,-252500
R214633,"NEILL,NICHOLAS M &","NEILL,NICHOLAS M",253500,10,-253490
R274554,"WARD,JAMES",HARDSCRABBLE ROAD LLC,254000,0,-254000
R206167,"MACKEY,JENNIFER","MACKEY,JENNIFER M TR",255000,0,-255000
R278628,"OLNEY,WARREN B &","OLNEY,WARREN B TR &",255000,0,-255000
R260010,"BOYLE,JAMES",NORTHWEST ACQUISITION &,255000,0,-255000
R162791,"SIMMONS,JUDI E","SIMMONS,JUDI E TR",255000,0,-255000
R317914,"KASZNIAK,JESSE &","KASZNIAK,JESSE",255000,0,-255000
R186021,"HOOFARD,JENNIFER","HOOFARD,JENNIFER M TR",255425,0,-255425
R101692,"THOMSON,GRAEME D &","THOMSON,GRAEME D",255555,0,-255555
R176452,"SAUNDERS,KENTON J TR-50% &",VICINAGE ASSETS LLC,256000,0,-256000
R227935,"FINNEY,DEBBIE L","FINNEY,DEBBIE",256200,0,-256200
R130492,"GROSHONG,BARBARA L","GROSHONG,BARBARA L TR",256293,0,-256293
R137129,"CASEY,MATTHEW","CASEY,MATTHEW &",256500,0,-256500
R240860,"HOGG,DONALD V","HOGG,DONALD V TR",257475,0,-257475
R209513,"KNOWLTON,JOHN P-90% &","KNOWLTON,ADAM &",257600,0,-257600
R295134,"RUBER,MICHELLE &",ENCIRCLE DESIGN AND BUILD LLC,258000,0,-258000
R309764,"GREGORY,JOEL","GREGORY,JOEL &",258000,0,-258000
R263753,"KNORR,CHRISTOF",BAU DESIGN LLC,258000,0,-258000
R200413,"BRODIE,DIANE",PALM STREET HOUSE LLC,259000,0,-259000
R182039,"MILES,DANIEL L &","MILES,DANIEL L",259000,0,-259000
R198934,"NICOTERA,JEANNA &","NICOTERA,JEANNA",259000,0,-259000
R107488,"HALL,MARK B &","HALL,MARK H &",259025,0,-259025
R146143,"CUTLER,WENDY E","CUTLER,WENDY E TR",259312,0,-259312
R497963,"KNAUL,PETRA","POLSON,KENNETH E &",259900,0,-259900
R210247,"GROSSENBACHER,MARY A","QUINTANILLA,LISA &",259900,0,-259900
R221568,"SMITH,CHARLES E &","SMITH,PATRICIA J",259900,0,-259900
R307787,"SCHIFBERG,NEIL &",DUMMKOPF LLC,260000,0,-260000
R275730,"CANADA,KATHERINE G","CANADA,KATHERINE G &",260000,0,-260000
R199186,"LAMBERT,ABIGAIL &","LAMBERT,ABIGAIL-1/2 &",260000,0,-260000
R113850,"HUDSON,ROSANNE E &","HUDSON,ROSANNE E &",260000,0,-260000
R203500,"LEE,ANNABELLE R TR 50% &","LEE,NELSON S &",260000,0,-260000
R265932,SWS LLC,SWS LLC,260000,0,-260000
R220414,"PARISH,JAMES R &",MAVERICK ENTERPRISES LLC,260000,0,-260000
R230771,"MCGRATH,CHRISTOPHER &","MCGRATH,CHRISTOPHER TR &",260000,0,-260000
R220821,"WILLIAMS,FREDA L","THROWER,ELLIOTT P",260000,0,-260000
R330583,NURE INC,"KHOSHNOOD,IRA TR",260000,0,-260000
R330583,NURE INC,MANDALAY BAY PROPERTIES,260000,0,-260000
R206114,"FOX,JOHN",SNYDER CONSTRUCTION LLC,261000,0,-261000
R259344,"SHAW,DAVID","SHAW,DAVID &",261000,0,-261000
R168686,"LAIN,CHARLES D &","LAIN,CHARLES D JR",262000,0,-262000
R275277,"SCHACKART,MARK A &",SUMMER WIND HOMES LLC,262400,0,-262400
R227116,THERM-O-LOC INC,THERM-O-LOC WINDOWS OF,262500,0,-262500
R199448,"PEAKE,MEREDITH","PEAKE,MEREDITH L TR",263000,0,-263000
R170588,"WILLIAMS,ARTHUR R &","WILLIAMS,LILLIAN",263400,0,-263400
R177602,"FERGUSON,PATRICK J &",FERGUSON FAMILY,263475,0,-263475
R577429,"CECCANTI,MELBA L","CECCANTI,MELBA L TR",264000,0,-264000
R278722,"BULLETSET,MARY E TR","BULLETSET,MARY E",264000,0,-264000
R283127,"MATELA,NANCY","MATELA,NANCY &",264000,0,-264000
R281077,"PROVAX,JOHN N TR-1/2 &","PROVAX,ALYSON R",264000,0,-264000
R214840,"CONN,FERRELL N","CONN,FERRELL N TR",264000,0,-264000
R219435,"WARD,LARRY N TR &","WARD,DONNA K TR",264220,0,-264220
R243980,"LAMONT,DAVID L","LAMONT,DAVID L TR",264750,0,-264750
R243980,"LAMONT,DAVID L","LAMONT,DAVID L TR",264750,0,-264750
R240066,"PACE,RANDY I &","JENKS,RUTH R",264900,0,-264900
R249241,AMERICAN HOMES 4 RENT,AMH 2014-2 BORROWER LLC,265000,0,-265000
R297971,"NITTA,GREGG &","NITTA,GREGG",265000,0,-265000
R242810,"CHANEY,PATRICK J TR &","CHANEY,PATRICK J",265000,0,-265000
R138669,WESTWOOD HOMES LLC,AARON ANGELO DEVELOPMENT LTD,265000,0,-265000
R254898,"BELISLE,KATHY &",DIAMOND IN THE ROUGH,265000,0,-265000
R319347,"PORTILLO,BARBARA M","PORTILLO,BARBARA M-24/25 &",265000,0,-265000
R262204,WEST COAST DEVELOPMENT,METRO HOMES NORTHWEST LLC,265000,0,-265000
R260012,"SMALL,VINCENT","SMALL,TIMOTHY L &",265000,0,-265000
R281683,"LOOMIS,MAGDALENE E &","LOOMIS,MAGDALENE E",265000,0,-265000
R265950,"SANDHU,JOHN &",ROSE CITY INVESTMENT GROUP LLC,266000,0,-266000
R317397,"FOLWELL,BYRON &","FOLWELL,BYRON &",267000,0,-267000
R597130,CLUNAS FUNDING GROUP INC,Sale In Progress,267050,0,-267050
R332640,"STONE,GLEN",PONDROCK LLC,267450,0,-267450
R329751,"MUELLER,DONALD A JR","MUELLER,DONALD A JR &",267500,0,-267500
R292109,"GUNDERSON,JESSICA B &",Sale In Progress,268000,0,-268000
R292109,"GUNDERSON,JESSICA B &","GUNDERSON,JESSICA B &",268000,0,-268000
R573953,"SERIGHT,SANDY D &","SERIGHT,SANDY D TR &",269000,0,-269000
R199645,"MARTIN,RACHEL","MELISSA,RACHEL L",269500,0,-269500
R130862,BEAUTIFUL BUNGALOW LLC,"MUIR,SARAH C",269950,0,-269950
R204931,"CLAWSON,MARK R &",Sale In Progress,269990,0,-269990
R204931,"CLAWSON,MARK R &","CLAWSON,MARK R &",269990,0,-269990
R226078,"WRIGHT,JEFF","WRIGHT,JEFF &",269999,0,-269999
R215829,"SCHOELLHAMER,DAVID &",DAVID SCHOELLHAMER AND,270000,0,-270000
R275680,"PETTERSON,JOY &","PETTERSON,JOY",270000,0,-270000
R336168,"LEWIS,PAULETTE E &","LEE,DENNIS A &",270000,0,-270000
R119370,"STROUT,PAUL","STROUT,PAUL-95% &",270000,0,-270000
R253869,"REY,SHARII E","REY,SHARII E TR",270000,0,-270000
R338012,"TONG,NGUYET T","NGUYEN,NGUYET T",270000,0,-270000
R154983,"OSBURN,HUGHEL R &","OSBURN,HUGHEL R TR &",270000,0,-270000
R196499,"GILMAN,LUCINDA &","GILMAN,LUCINDA M &",270000,0,-270000
R253869,"REY,SHARII E","REY,SHARII E TR",270000,0,-270000
R208926,RP & ASSOCIATES,RP & ASSOCIATES LLC,270000,0,-270000
R253869,"REY,SHARII E","REY,SHARII E TR",270000,0,-270000
R254853,"SHAW,DENNIS &","SHAW,DENNIS &",270400,0,-270400
R254853,"SHAW,DENNIS &","SHAW,DENNIS A TR &",270400,0,-270400
R159586,BLEECKER & PERRY LLC,4815 SE LINCOLN LLC,271000,0,-271000
R159586,BLEECKER & PERRY LLC,Sale In Progress,271000,0,-271000
R305491,RP & ASSOCIATES,RP & ASSOCIATES LLC,271000,0,-271000
R271352,"RAWSON,RICHARD E","RAWSON,RICHARD E &",272000,0,-272000
R126994,"MAXSON,BARRIE &","MAXSON,BARRIE TR &",272000,0,-272000
R300781,"LEWIS,KENT J &",DWELL PROPERTIES LLC,272500,0,-272500
R319228,"SCHATZ,ADAM &","SCHATZ,ADAM &",273000,0,-273000
R128027,"HODGE,CARROLL A","HODGE,CARROLL TR",273500,0,-273500
R128027,"HODGE,CARROLL A",Sale In Progress,273500,0,-273500
R212093,"STONE,L GAIL",STONES BEAUTY HOMES LLC,273500,0,-273500
R282016,"HULL,ROBERT W &","HULL,ROBERT W &",274000,0,-274000
R236587,"SWARM,ROBERT A &",NORTHERN CALIFORNIA CONFERENCE,274000,0,-274000
R203209,"KESKE,MARCIA G &","KESKE,MARCIA G &",275000,0,-275000
R278619,"MORROW,CHESTER R &","MORROW,PAULINE F",275000,0,-275000
R160370,"BLAGA,CHRISTIAN E &","BLAGA,ELENA L &",275000,0,-275000
R323946,"HART,ANTHONY R &","CRUTCHER,RONALD L &",621000,345000,-276000
R206356,"RODER,MARC A","RODER,MARC A TR",276900,0,-276900
R292305,"LYMBERIS,PETE G &",SPETYA HOLDINGS LLC,278418,0,-278418
R292305,"LYMBERIS,PETE G &",Sale In Progress,278418,0,-278418
R277806,"CAPOBIANCO,MARYANNE","WEST,KATHLEEN ET AL",278700,0,-278700
R295410,"TANSILL,DOUGLAS F","TANSILL,DOUGLAS F &",279000,0,-279000
R158598,"MC ELROY,ALENA","MCELROY,ALENA &",279000,0,-279000
R158598,"MC ELROY,ALENA","MCELROY,ALENA &",279000,0,-279000
R322534,"STIEF,DIANE","STIEF,DIANE W TR",280000,0,-280000
R611090,"BRENTE-FAIR,ELISA","FAIR,FRANK M TR &",280000,0,-280000
R307617,"BENOIT,KAREN A TR",ST BENOIT LLC,280000,0,-280000
R130751,"IMBERT,LOUIS TR &","IMBERT,LAETITIA",280000,0,-280000
R118609,"HUFFT,JANE W &",Sale In Progress,280000,0,-280000
R303133,"SHAFER,MICHAEL T &",Sale In Progress,280000,0,-280000
R118609,"HUFFT,JANE W &",JBR HOLDINGS LLC,280000,0,-280000
R303133,"SHAFER,MICHAEL T &","SHAFER,MICHAEL TR &",280000,0,-280000
R118609,"HUFFT,JANE W &",JBR HOLDINGS LLC,280000,0,-280000
R279114,"STOUT,JOHN &","STOUT,JOHN C TR &",280000,0,-280000
R222172,"HEADINGS,VIVIAN","HEADINGS,VIVIAN J TR",280000,0,-280000
R588539,"MOSCATO,LOUIS J &","MOSCATO,LOUIS J ET AL",280000,0,-280000
R137176,"HAYNE,LLOYD E &","HAYNE,LINDA F",280000,0,-280000
R573834,"PRASAD,ASHWINI S &","SARGENT,GEORGE",280500,0,-280500
R295027,"CURTIN,MICHAEL H &","CURTIN,MICHAEL H",305500,24960,-280540
R253353,"PIPER,BERYL D &","MICHAEL,GLADYS M TR &",281000,0,-281000
R300664,"VAN HORN,NEAL F &","VAN HORN,NEAL F TR &",281000,0,-281000
R164842,"COHEN,JAMES D",26TH DRIVE LLC,281725,0,-281725
R160999,"WHITTON,MARK J &","WHITTON,SHAWNA I",282000,0,-282000
R172276,"HUANG,HSIN YA","HUANG,HSIN YA &",283000,0,-283000
R311374,"ADAMS,EDWIN E &","ADAMS,EDWIN E",285000,0,-285000
R138018,"ARROWSMITH,RICHARD C","ARROWSMITH,RICHARD C &",285000,0,-285000
R124165,"STOUT,EDWARD &","STOUT,MIKE",285000,0,-285000
R127938,"CONTE,CARRIE","CONTE,CARRIE A TR",285000,0,-285000
R197448,COHO NW INVESTMENTS LLC,"PFANNES,MICHAEL A &",285000,0,-285000
R193671,"ROWE,JULIANNA M &","ROWE,DAVID J &",285000,0,-285000
R158683,"DAY,COURTNEY","DAY,COURTNEY A",285000,0,-285000
R188763,"AMBES,ROBERT","AMBES,ROBERT P TR",285000,0,-285000
R230216,BKB INVESTMENTS LLC,COTD III LLC,285000,0,-285000
R260615,"BUNDY,PAUL D",BUNDY HOMES LLC,285000,0,-285000
R190505,"WILLIAMS,MARGARET","WILLIAMS,MARGARET E TR",286065,0,-286065
R228808,"ROUSE,JAMES T &","ROUSE,JAMES T",286500,0,-286500
R137280,"WETHINGTON,BRIAN J &","WETHINGTON,BRIAN TR &",286500,0,-286500
R137280,"WETHINGTON,BRIAN J &","WETHINGTON,BRIAN TR &",286500,0,-286500
R174722,"MITCHELL,JODEEN &","MITCHELL,JODEEN",287080,0,-287080
R308000,"CRYMES,ALAN E &","CRYMES,ALAN E TR &",287500,0,-287500
R123582,"WARD,GRETCHEN &","MCPHERSON,JEREMIAH K &",287900,0,-287900
R114180,"TARUMI,MICHAEL V M &","TARUMI,MICHAEL ET AL",288000,0,-288000
R277650,"QUIGLEY,JULIEANNE &","QUIGLEY,JULIEANNE &",288300,0,-288300
R147373,"SEGER,JEANINE &",3626 NE 16TH LLC,289000,0,-289000
R195370,"BEAVON,EVERYL","BEAVON,EVERYL TR",289000,0,-289000
R291958,"MC KINNON,SCOTT A &","LARONDELLE,DAVINA",289000,0,-289000
R277012,"PROCTOR,DARALYN R",SKYLANE LLC,290000,0,-290000
R186641,"MARQUARD,WILLIAM A TR &","MARQUARD,MICHAEL",290000,0,-290000
R186641,"MARQUARD,WILLIAM A TR &","MARQUARD,MICHAEL",290000,0,-290000
R177298,"LUONG,PETER &","LUONG,PETER TR &",290000,0,-290000
R263128,"TREE,J ELISSA","TREE,J ELISSA TR",290000,0,-290000
R104429,"DEUTSCH,DANIEL C",WWR LLC,290000,0,-290000
R153974,"THOMAS,RONALD G &","THOMAS,RONALD G TR &",290000,0,-290000
R279055,"HELGERSON,JOSEPH &","HELGERSON,JOSEPH-50% &",290000,0,-290000
R153974,"THOMAS,RONALD G &","THOMAS,RONALD G TR &",290000,0,-290000
R168089,"MICHEL,FRED D","MICHEL,FRED D &",290000,0,-290000
R621352,"O'CONNELL,BREANNA","O'CONNELL,BREANNA &",290000,0,-290000
R219322,BLEECKER & PERRY LLC,1346 SE MALDEN LLC,292000,0,-292000
R157701,"THOMAS,ELIZABETH",PROPERTY OWNER,292000,0,-292000
R195373,"SARONI,LINDA R","SARONI,LINDA R TR",292000,0,-292000
R197317,"KRUEGER,TRACY &",KEYSTONE RENOVATIONS LLC,292000,0,-292000
R541339,"INGHEL,CONSTANCE H TR","ZIFF,YOLLANDA I TR",292000,0,-292000
R586329,2 OLD FOOLS LLC,"EVANS,DONALD G &",292000,0,-292000
R177333,"KELTON,LYNNE","KELTON,LYNNE A TR",292500,0,-292500
R100858,"CARNAHAN,MICHAEL L","CARNAHAN,MOLLY M",293000,0,-293000
R265533,"WEST,DONALD C &","WEST,DONALD C TR &",294000,0,-294000
R160032,"MICHAEL,DOUGLAS G","DOUGLAS,MICHAEL G-1/2 &",294000,0,-294000
R122803,4918 NE 9TH LLC,2335 SE 26TH LLC,294319,0,-294319
R189754,"APPEL,STEVE","APPEL,STEVE R &",294450,0,-294450
R307286,"CROSSLAND,CLAY &",CROSSKEY LLC,294900,0,-294900
R236547,"WINANS,ROYCE A","WINANS,ROYCE A &",295000,0,-295000
R331987,"MCKEE,LYDIA E EST OF &","SNYDER,PATRICIA A",295000,0,-295000
R272340,"WALES,JAMES &","WALES,JOAN V",295000,0,-295000
R117512,"FERGUSON,ANTHONY &","CARDIEL,ROVENA &",296000,0,-296000
R563963,"BERG,RYAN A &","BERG,RYAN A",297000,0,-297000
R144343,"TRICAMO,JOAN","TRICAMO,JOAN TR &",297000,0,-297000
R150786,"THOMSON,JAMES","THOMSON,JAMES L TR",297500,0,-297500
R272483,M & J REAL BUYER'S LLC,"EBERLE,MARTIN J",298000,0,-298000
R294269,"ARENZ,JOE",JONTE DEVELOPMENT LLC,298300,0,-298300
R277956,"UEDA,SHAWN-51% &","UEDA,SHAWN",299000,0,-299000
R318715,"MOORE,EVERETT M &","MOORE,DEBORAH J",299000,0,-299000
R278757,"BERGSTROM,DONALD E &","BERGSTROM,DONALD E TR-1/2 &",299000,0,-299000
R278757,"BERGSTROM,DONALD E &","BERGSTROM,DONALD E TR-1/2 &",299000,0,-299000
R262559,"FICK,NATHAN D &","FICK,CHRIS &",299000,0,-299000
R198923,"LIVELY,MARK &","LIVELY,MARK &",299900,0,-299900
R129486,"CHALMERS,HUGH J","WEBB,CHARLES G",299900,0,-299900
R137108,"KARLIN,HANNA","KARLIN,HANNA",299950,0,-299950
R579131,"NGUYEN,PHUONG &","NGUYEN,QUANG &",300000,0,-300000
R241533,RP & ASSOCIATES CONSTRUCTION,RP & ASSOCIATES LLC,300000,0,-300000
R203284,"BUTLER,KELLY","DELANEY,REGAN P &",300000,0,-300000
R219235,"WHEELER,CHARLES &","WHEELER,CHARLES &",300000,0,-300000
R295809,"CODDING,CONSTANCE L","CODDING,CONSTANCE L TR",300000,0,-300000
R219235,"WHEELER,CHARLES &","WHEELER,CHARLES T TR &",300000,0,-300000
R278785,"JOHNSON,VIRGINIA V &","JOHNSON,FREDERIC D D TR &",300000,0,-300000
R279112,"COLBERT,JESSE &","COLBERT,JESSE L TR",300000,0,-300000
R212592,"BURNS,CHRISTOPHER &","BURNS,CHRISTOPHER &",300000,0,-300000
R275895,"SMITH,SUSAN L &","SMITH,SUSAN L TR &",300000,0,-300000
R155495,"RICHESON,PAUL E &","RICHESON,PAUL E",300000,0,-300000
R558002,"BEIERSCHMITT,AARON D","BEIERSCHMITT,AARON D &",300000,0,-300000
R278760,"LOGAN,NORMAN D TR &","LOGAN,KATHLEEN R TR",300000,0,-300000
R266002,"KIRSTEIN,KERRY A",GOOD TUESDAY LLC,300000,0,-300000
R148028,"BLIVEN,DARRYL J &","BLIVEN,DOROTHEA E",300000,0,-300000
R540025,"MANNING,RANDY P","MANNING,RANDY &",300000,0,-300000
R103186,"MARTIN,MICHAEL A","MARTIN,MICHAEL A &",300500,0,-300500
R178842,"TOBEY,JEANNE L","TOBEY,JEANNE L &",300657,0,-300657
R532884,"O'BRIEN,ANDREW &","O'BRIEN,ANDREW TR &",300737,0,-300737
R124927,"ROSEMAN,ROSALIND M &","ROSEMAN,ROSALIND M TR &",301275,0,-301275
R284259,"FOGARTY,DOUGLAS R &","FOGARTY,DOUGLAS R TR &",302000,0,-302000
R278986,"HEFNER,CORDELIA R","HEFNER,CORDELLA R TR &",303000,0,-303000
R281020,GEORGENS ASSOCIATES INC,"GEORGENS,KATHERINE-80% &",303500,0,-303500
R281020,GEORGENS ASSOCIATES INC,"GEORGENS,KATHERINE-80% &",303500,0,-303500
R487951,"COOK,TERRANCE","COOK,TERRANCE L TR",304000,0,-304000
R251186,"MURRILL,MARY B &",DAVID M DURHAM & MARY BETH,304200,0,-304200
R304016,"OLIVER,RUSSELL T &","OLIVER,RUSSELL T TR &",305000,0,-305000
R249391,"YODER,REBECCA","YODER,REBECCA L TR",305000,0,-305000
R132238,"VERZURA,BETTY L","VERZURA,BETTY L TR",305000,0,-305000
R262474,"KATZ,LORIN R",GASLIGHT PROPERTIES LLC,305000,0,-305000
R167112,"STINGLE,ROBERT O",FULTON PARK LLC,305000,0,-305000
R540035,"BARRIER,THAD &","BARRIER,THAD ET AL",305000,0,-305000
R238519,"OLICH,EUGENE TR",Sale In Progress,305000,0,-305000
R238519,"OLICH,EUGENE TR","OLICH,MICHAEL E",305000,0,-305000
R291880,"CHELLIS,KATHLEEN A",CHELLKAT RESIDENTIAL LLC,305580,0,-305580
R200214,"GILBERT,CLAUDE &","GILBERT,CLAUDE &",306000,0,-306000
R253145,"GILL,MICHAEL &","GILL,MICHAEL &",306000,0,-306000
R136610,"HARRIS,JAMEY","HARRIS,JAMES M",306150,0,-306150
R206891,"WILLIAMS,FREDA L","THROWER,LA SHAWNA J",306500,0,-306500
R303027,S KAY G LLC-67% &,"JOHNSON,ANGELA J &",307000,0,-307000
R303027,S KAY G LLC-67% &,"GRUBB,SANDRA K-67% &",307000,0,-307000
R311716,"FRANCO,NANCY",DELTA REAL ESTATE LLC,307500,0,-307500
R149610,"DIERINGER,EUGENE G &","DIERINGER,EUGENE G TR &",307500,0,-307500
R134268,TWYMAN & BANKS L L C,"BANKS,ALEX &",308000,0,-308000
R180685,"MELLAND,T R &","MELLAND,TOMMY R TR &",308000,0,-308000
R336966,"PERLINGIERI,LEAH","PERLINGIERI,LEAH &",308000,0,-308000
R103063,BROOKLYN'S BEST DESIGN CO LLC,3959 NE MALLORY LLC,308999,0,-308999
R306519,TAX FREE EXCHANGE CO LLC,"GIGNILLIAT,T HEYWARD",309000,0,-309000
R267434,"GOLDSTEIN,NANCY M","MCMATH,NANCY M",309500,0,-309500
R290867,HALO ENTERPRISES LLC,"SAYLER,SHARON L",309900,0,-309900
R303257,"SAUTER,ROBERT &","SAUTER,DAVID J",310000,0,-310000
R250309,"STEVENS,INGRID &","STEVENS,INGRID M-70% &",310000,0,-310000
R303257,"SAUTER,ROBERT &","SAUTER,ROBERT &",310000,0,-310000
R296627,"BAJEMA,RUTH B","BAJEMA,RUTH B TR",310000,0,-310000
R306522,"STONE,GARY &","STONE,GARY L TR &",310000,0,-310000
R292214,"KESSI,ROBERT K &","ANDREW,DAN",310000,0,-310000
R104155,"MITCHELL,JOHN H TR &","MITCHELL,GWEN TR",310000,0,-310000
R271626,RP & ASSOCIATES,RP & ASSOCIATES LLC,311000,0,-311000
R118993,"PON,JULIE &","PON,JULIE",311500,0,-311500
R270728,EVERETT CUSTOM HOMES INC,EDEN ENTERPRISES LLC,775000,463000,-312000
R150960,"HOFFMAN,ARLO-25% &","ZIMMERMAN,LEILANI",420400,106950,-313450
R118632,"HECKLER,THOMAS &","HECKLER,THOMAS M",314000,0,-314000
R190093,"HALL,MARLENE D &","HALL,MARLENE D",314900,0,-314900
R278911,"VAN BUREN,MARY B","VAN BUREN,MARY B SURVIVING",315000,0,-315000
R536635,"CHAN,JEFFREY","CHAN,JEFFREY K",315000,0,-315000
R197583,"MC CLEARY,STANDISH",MRE HOLDINGS LLC,315000,0,-315000
R273850,"HOLLAND,JEFF",PROPERTY OWNER,315000,0,-315000
R291898,"KENDRICK,SHANNON &","WOLF,BOB K &",315000,0,-315000
R270296,"SACHER,FRANCES &","SACHER,FRANCES TR &",315000,0,-315000
R488539,"MILLER,DONALD R &","BEALS,RICHARD &",315000,0,-315000
R274013,"KRAUSKOPF,TIMOTHY","HOWLAND,MELE",315000,0,-315000
R329925,"BECKER,SYLVIA K","BECKER,SYLVIA K TR",315000,0,-315000
R304294,"JONSSON,ROBERT E","JONSSON,ROBERT E &",315000,0,-315000
R231772,"EVENS,MERYL","EVENS,JULES G TR &",316500,0,-316500
R210145,28TH STREET CONDOMINIUMS,18TH STREET INVESTMENT LLC,317350,0,-317350
R225047,"SMITH,KATHLEEN S &",Sale In Progress,317450,0,-317450
R225047,"SMITH,KATHLEEN S &","SMITH,DENNIS E TR &",317450,0,-317450
R145363,"KOSTA,JEAN C &","GYGAX,JANET E",317500,0,-317500
R331273,LOGAN INVESTMENT CONSULTING,"LOGAN,ROBERT J &",317500,0,-317500
R212069,"BARISICH,DANIEL F-1/2 &","BARISICH,DANIEL F-1/2 &",318000,0,-318000
R142468,"FERGUSON,PAT &",FERGUSON FAMILY,318000,0,-318000
R154113,"ANDERSON,NATALIE W","WARNER,NATALIE W",320000,0,-320000
R590994,"MARGOLIN,DANIEL S &","GEIGER,WILLIAM J III",1020000,700000,-320000
R279141,"LAVIOLETTE,REBECCA A","LAVIOLETTE,REBECCA A &",320000,0,-320000
R281143,"GRAY,DAVID R &","GRAY,DAVID R TR &",320000,0,-320000
R280929,"ANDERSON,MIKE &",MADISONPDX LLC,320000,0,-320000
R541323,"CROASDAILE,TIMOTHY J &","CROASDAILE,CYNTHIA B TR &",320000,0,-320000
R291794,"MORSE,BRADLEY K",BKM PROPERTIES LLC,320000,0,-320000
R169422,"FOLBERG,ROSS V","FOLBERG,ROSS V &",320000,0,-320000
R267419,"FORDYCE,JEAN C TR &","FORDYCE,JEAN C TR",320000,0,-320000
R230103,"HUNT,BILLY &","HUNT,JULIE A &",320000,0,-320000
R265250,"MC CAUGHEY,KEVIN L &","MCCAUGHEY,KEVIN L &",320000,0,-320000
R167452,"REED,MICHAEL R SR",CLUNAS FUNDING GROUP INC,320000,0,-320000
R189491,"ARGINTAR,ANDREW &","ARGINTAR,SUSAN K &",321000,0,-321000
R304350,"GUBNER,RICHARD &","GUBNER,RICHARD E TR &",322000,0,-322000
R284306,"LARSON,SUSAN F","LARSON,SUSAN F &",322125,0,-322125
R117820,"TSAI,LINDA LING-LING YEN","YEN,LINDA L L TR",322900,0,-322900
R145441,"VOLLMER,JAMES &","SPENCER,SUSAN J",323500,0,-323500
R114164,"BENDIS,BRIAN &","BENDIS,BRIAN TR &",324000,0,-324000
R162607,"GILBERT,MITCH &",MG-MK SE 38TH PROPERTY LLC,324000,0,-324000
R201812,"AUTHIER,BRAD &","AUTHIER,BRAD TR &",325000,0,-325000
R237021,"CHAPMAN,JULIA A","CHAPMAN,JULIA TR",325000,0,-325000
R134547,"STOCKER,LEE J &",AJ STOCKER LLC,325000,0,-325000
R273459,ADVANTAGE EQUITIES LLC 6968 &,"NORMAN,JUSTIN &",325000,0,-325000
R238743,"OSMUN,RICHARD &","OSMUN,RICHARD D TR &",325000,0,-325000
R149517,"MERCER,MICHAEL E","MERCER,MICHAEL E &",325000,0,-325000
R134547,"STOCKER,LEE J &",AJ STOCKER LLC,325000,0,-325000
R161339,"HORNE,MARVIN W &","HORNE,CHERYL L",325000,0,-325000
R190758,RP & ASSOCIATES LLC,CLUNAS FUNDING GROUP INC,325000,0,-325000
R330584,KAZCO OF OREGON LLC,"KERN,ZACK",325500,0,-325500
R277252,"HERNANDEZ,PETER &","KNOX,JANET &",326000,0,-326000
R309513,BURNETT WOODS LLC,FOUNTAIN SQUARE LLC,326000,0,-326000
R279126,"STANLEY,FREYA &","STANLEY,FREYA TR-40% &",327000,0,-327000
R303000,"RAMSEY,PATRICIA A &","RAMSEY,PATRICIA A",328000,0,-328000
R277164,"WALDEN,CURNEL A &","WALDEN,CURNEL A &",328700,0,-328700
R260248,"LUCK,DIANE",SF INVESTMENTS NORTHWEST LLC,329000,0,-329000
R157647,M16 LLC,LITTLE DELTA THREE LLC,329900,0,-329900
R289312,"JACOBSEN,PETE T &","JACOBSEN,PETER T TR &",329900,0,-329900
R154937,"SIEFERT,DAVID W","SIEFERT,DAVID W TR",330000,0,-330000
R312839,"EDERA,MICHAEL A &","EDERA,MICHAEL A &",330000,0,-330000
R127039,WMS SPRING GARDEN X LLC,"SANDERS,WILLIAM J &",330000,0,-330000
R238164,"FURE,JAN","FURE,JAN &",330000,0,-330000
R224107,"SHONE,STEVEN &","SHONE,STEVEN",330000,0,-330000
R259282,HORIZON MANAGEMENT GROUP LLC,PORTLAND DEVELOPMENT GROUP LLC,330000,0,-330000
R177601,PATHFINDERS HOMES INC,"MASTRANUNZIO,KEITH A &",330000,0,-330000
R315337,"REINERT,GREGORY &","REINERT,GREGORY &",331000,0,-331000
R115767,"SNODDY,SELMA L","LI,SELMA",331500,0,-331500
R153215,"KINNE,JARED",RED GAP HOLDINGS LLC,332000,0,-332000
R253368,"BORLAND,DOLORES F TR","BORLAND,DAVID L TR",332000,0,-332000
R162846,"PARR,ALBERT C &","PARR,ALBERT C TR &",332000,0,-332000
R229137,"STERENBERG,RUSSELL K &","STERENBERG,RUSSELL K TR &",332000,0,-332000
R226550,"PRIBYL,MARY J TR","PRIBYL,LIZ",333000,0,-333000
R226550,"PRIBYL,MARY J TR",Sale In Progress,333000,0,-333000
R330201,"HAIN,BRIAN W &","HAIN,BRIAN &",334000,0,-334000
R207310,"HAZLITT,DONNA J","HAZLITT,DONNA J TR",334148,0,-334148
R249226,"SONI,SILEEN S &","SONI,SHIV KUMAR TR &",334950,0,-334950
R228595,"BACHHUBER,STEPHEN R &","BACHHUBER,IRENE J TR &",335000,0,-335000
R288427,"LUCK,DIANE","LUCK,DIANE &",335000,0,-335000
R125703,"WILSON,ROBERT F &",RE WILSON J LIMITED,335000,0,-335000
R278815,"SPINA,ALBERT E &","SPINA,ALBERT E TR &",335000,0,-335000
R121827,"WILKINS,ANTHONY J JR &","WILKINS,ANTHONY J JR TR &",335000,0,-335000
R309736,"GREEN,MILTON B &","GREEN,HEATHER TR",335000,0,-335000
R309736,"GREEN,MILTON B &","GREEN,HEATHER TR",335000,0,-335000
R279094,"ROECKER,RONALD M &","ROECKER,RONALD M &",335000,0,-335000
R279094,"ROECKER,RONALD M &","ROECKER,RONALD M TR &",335000,0,-335000
R174393,"KIRK,MICHAEL R",LUCI CORPORATION,336500,0,-336500
R280870,"ROMBERG,JULIE A","ROMBERG,JULIE TR",337000,0,-337000
R332564,"MC LAREN,JESSICA","MCLAREN,JESSICA-1/3 &",337000,0,-337000
R210475,"MCNAMARA,SUSAN","MCNAMARA,SUSAN M TR",337500,0,-337500
R114182,"BRUGATO,CATHERINE &","MEREDITH,GREGORY R TR &",337500,0,-337500
R299300,"MITTELSTAEDT,TYLER S &","MITTELSTAEDT,TYLER S &",339000,0,-339000
R302868,ALDRIDGE MTN DEVELOMENT LLC,"LAMB,KRISTI L &",339000,0,-339000
R307133,"SIEGEL,DARREN &","SIEGEL,DARREN B &",339000,0,-339000
R267886,"RYAN,SHAWN","LIOY-RYAN,SHAWN &",339900,0,-339900
R602458,"PRADO,ERIC &","PRADO,ERIC",339900,0,-339900
R318749,"BECKSTROM,LANCE A &","BECKSTROM,CECIL L &",340000,0,-340000
R558436,"GRAY,JAMES P &","GRAY,JAMES P TR &",340000,0,-340000
R255369,"CHRISTIE,JONATHAN G &","CHRISTIE,JONATHAN G",340000,0,-340000
R330423,"KOVAL,ALEKSANDR",CLASSIC IMAGE HOMES LLC,340000,0,-340000
R186347,"HAYES,KEVIN","HAYES,KEVIN &",340000,0,-340000
R102787,"NOVINGER,BENJAMIN T ET AL","NOVINGER,BENJAMIN T &",340000,0,-340000
R220918,"BOUDREAUX,ALLEN R","BOUDREAUX,JESSICA T",340000,0,-340000
R239392,"IRVINE,ROBERT &","IRVINE,SUSAN S TR",340000,0,-340000
R124124,"MAKLER,MICHAEL T &","MEYER,CYNTHIA G",340000,0,-340000
R137658,"BORTOLAZZO,BENVENUTO &","BORTOLAZZO,BENVENUTO &",340000,0,-340000
R200504,"SILVA,JASON &",MHT ASSETS LLC,340000,0,-340000
R118374,"MCCOY,RYAN D","MCCOY,RYAN D &",340000,0,-340000
R287991,"LANG,JEREMY &","LANG,JEREMY W &",340000,0,-340000
R294435,"HYDE,HILLARY A","HYDE,HILLARY A TR",340000,0,-340000
R106815,"HOWARD,BRUCE C",RENAISSANCE CUSTOM HOMES LLC,340000,0,-340000
R147460,"LEEB,AARON &",ZEPHYR DEVELOPMENT LLC,342000,0,-342000
R332522,"WALKER,CAMELLIA &",SPROUT 76 LLC,342500,0,-342500
R179618,"WREN,JAIME J-1/3 &","WREN,JAIME J &",342800,0,-342800
R304192,"STINSON,LESTER P &","STINSON,CATHY L TR &",342870,0,-342870
R188706,"MIZIOLEK,BOGUSLAW &","MIZIOLEK,IRINA &",343000,0,-343000
R299293,"MORGAN,VANESSA &","MORGAN,DAVID S TR &",343280,0,-343280
R142596,"JUELSON,BARBARA J C TR","COLTON-JUELSON,BARBARA J TR",343500,0,-343500
R190415,PDX RENOVATIONS LLC,EVERETT CUSTOM HOMES INC,430000,85000,-345000
R115040,"WHEATLEY,WILLIAM R-50% &","WHEATLEY,WILLIAM R",345000,0,-345000
R280000,"CAMPBELL,BRUCE &","CAMPBELL,BRUCE TR &",345000,0,-345000
R171740,"COGAN,ANNETTE","COGAN,EDWARD B TR &",345000,0,-345000
R278271,"FORD,NICHOLAS T &","FORD,NICHOLAS T",345000,0,-345000
R137635,"GOETCHEUS,ANN","GOETCHEUS,ANN B TR",345000,0,-345000
R114089,KEZA LLC,"FOSTER,SHALISAN L",345500,0,-345500
R209076,"ELLIS,KIMBERLY","SHEERN,KIMBERLY &",346000,0,-346000
R189747,"HERTEL,DAVID &","HERTEL,DAVID R TR &",349000,0,-349000
R332927,"MAERTZ,ALLEN &","MAERTZ,ALLEN &",349000,0,-349000
R332927,"MAERTZ,ALLEN &","MAERTZ,ALLEN &",349000,0,-349000
R233121,"GAUDETTE,FRANCIS X",KIMCO PROPERTIES KTD,349900,0,-349900
R277106,"BURKE,TERI A","YOUNG,ROBERT C",349950,0,-349950
R188887,"SHAHIDZADEH,SHAHROKH","SHAHIDZADEH,SHAHROKH &",350000,0,-350000
R212160,PARK FOREST GROUP LLC,PARK FOREST GROUP LLC-49% &,350000,0,-350000
R279163,"NELSEN,DAVID L &","NELSEN,DAVID L &",350000,0,-350000
R265521,"GEBREYESUS,TESHALE T","GEBREYESUS,TESHALE T &",350000,0,-350000
R258414,"MURRAY,PETER","MURRAY,PETER F &",350000,0,-350000
R165432,"BOUDREAUX,ALLEN R &","RYU,IN KEUN &",1750000,1400000,-350000
R204026,"RAILTON,EVAN &","RAILTON,EVAN",350000,0,-350000
R204026,"RAILTON,EVAN &","RAILTON,EVAN",350000,0,-350000
R313005,"SMITH,PETER W &","SMITH,MARY H &",350000,0,-350000
R278555,"POZZI,KATHLEEN M TR","POZZI,KATHLEEN M",350000,0,-350000
R160409,"BERCHTOLD,DONALD J &","HANKS,NOELLE A &",351000,0,-351000
R186450,"LOVEJOY,TRAVIS &","LOVEJOY,JENNETTE P &",351000,0,-351000
R200795,"FUJIYOSHI,MARILYN","FUJIYOSHI,MARILYN TR",352443,0,-352443
R289470,"WILLSON,S BRIAN",Sale In Progress,353000,0,-353000
R226530,"DONLEY,ROBERT M &","DONLEY,ROBERT M TR &",353000,0,-353000
R289470,"WILLSON,S BRIAN","WILLSON,S BRIAN TR &",353000,0,-353000
R266063,"PARKHURST,SHARON","PARKHURST,SHARON L TR",353500,0,-353500
R277211,GOOD SHEPHERD LUTHERAN,BETHESDA LUTHERAN,355000,0,-355000
R247479,"CLAYTON,RICHARD G","CLAYTON,BARRY J &",355000,0,-355000
R496108,"BEAL,GARY","BEAL,GARY &",355000,0,-355000
R309697,"RASMUSSEN,LAUREN","RASMUSSEN,LAUREN TR",356556,0,-356556
R106488,EXCHANGE ACCOMODATORS INC,"PARIS,JACQUELINE &",357500,0,-357500
R140919,BELMONT INVESTMENTS,"ANAND,BRIJESH &",358000,0,-358000
R303652,"BASSETT,KAREN L","BASSETT,KAREN L TR",359500,0,-359500
R303652,"BASSETT,KAREN L","BASSETT,KAREN L",359500,0,-359500
R326711,"MONGA,MARY","MONGA,MARY B TR",359900,0,-359900
R184301,"MORGAN,MATTHEW E","MORGAN,MATTHEW E &",360000,0,-360000
R313887,"HOFFART,HERBERT J",SFR HOLDINGS LLC,360000,0,-360000
R207132,"BLACK,AMANDA","BLACK,AMANDA M TR",360000,0,-360000
R139327,"ST MARK,JAMIE D","ST MARK,JAMIE D TR",360000,0,-360000
R200701,"SUN,ICHIANG","SUN,ICHIANG &",360000,0,-360000
R141829,"VANDERSLICE,DUANE &","VANDERSLICE,NATHAN A &",360000,0,-360000
R298851,"LOGAN,KRYSIA Z","ZARODA,KRYSIA M",361000,0,-361000
R307286,RP & ASSOCIATES CONSTRUCTION,RP & ASSOCIATES LLC,361000,0,-361000
R230764,"WARD,LUCAS","WARD,LUCAS &",361000,0,-361000
R306049,"KEARNEY,N LEE JR &","KEARNEY,JULIE F",361500,0,-361500
R306049,"KEARNEY,N LEE JR &","KEARNEY,JULIE F",361500,0,-361500
R262543,DILUSSO HOMES LLC,DILUSSO HOMES LLC &,362000,0,-362000
R223280,"BORTNICK,MAX H","BORTNICK,MAX H TR",362500,0,-362500
R167108,"MALONEY,DANIEL G ET AL","KEMALYAN,NATHAN A &",363000,0,-363000
R279169,"GUSTAFSON,RONALD H &","GUSTAFSON,RONALD H TR-1/2 &",363152,0,-363152
R154053,"JOHNSON,RANDY","FERGUSON,DRACO T TR",364000,0,-364000
R258415,"BACHELOR,BRIAN",OJB PROPERTIES LLC,364000,0,-364000
R154319,"REILLY,JOHN K","REILLY,JOHN &",365000,0,-365000
R229135,"THOENI,JOHN L &","THOENI,JOHN L",365000,0,-365000
R292028,"BENOIT,KAREN A TR",YALE ST LLC,365000,0,-365000
R292028,"BENOIT,KAREN A TR","BENOIT,KAREN A TR",365000,0,-365000
R317733,"COUGHLIN,CLAUDIA S","COUGHLIN,CLAUDIA S TR",365088,0,-365088
R330938,"HALL,SUSAN J TR","HALL,JONATHAN R",365500,0,-365500
R259934,"KELLOGG,SEAN M &","KELLOGG,SEAN &",366000,0,-366000
R126405,"RICHINGS,LAURA","RICHINGS,LAURA",367000,0,-367000
R150707,"HALDE-BUTTERWORTH,SUSAN","HALDE-BUTTERWORTH,SUSAN L",368000,0,-368000
R161322,"BARNETT,LARRY L &","BARNETT,LARRY TR &",369000,0,-369000
R113107,"REILLY,JOHN K &",REILLY SIGNATURE HOMES LLC,369000,0,-369000
R260941,"FIELD,JOHN M &",TRIPLE FIELD LLC,370000,0,-370000
R331219,"URBINA,JOE &","URBINA,JOE M TR &",370000,0,-370000
R329285,"NAKATSUJI,SHIRO","NAKATSUJI,SHIRO &",370000,0,-370000
R255304,"DANIELS,BLAKE",ROCKLAND INVESTMENTS INC,370000,0,-370000
R219995,"VANDAM,EDWIN M &","VANDAM,EDWIN M TR &",370000,0,-370000
R123038,"JONES,BRYAN &","JONES,BRYAN &",370000,0,-370000
R329747,"PHILLIPS,ROBERT W TR &","PHILLIPS,SHARON R TR",370000,0,-370000
R306128,"DENSON,CHARLES D &","DENSON,CHARLES D",370000,0,-370000
R340211,"WILSON,KIRK E","WILSON,KIRK E TR",370000,0,-370000
R340211,"WILSON,KIRK E",Sale In Progress,370000,0,-370000
R162171,"ALAYASA,JEHAD Y","ABUSHAKRAH,JANICE TR",371000,0,-371000
R273432,"JONES,KENNETH",ROCKLAND INVESTMENTS INC,374000,0,-374000
R114574,"SPINELLA,JOSEPH A","CONNOLLY,JOHN A TR &",375000,0,-375000
R226961,"AUSTIN,BRIAN D &","AUSTIN,RACHEL E &",375000,0,-375000
R308829,"GREEN,MATTHEW W &","GREEN,MATTHEW W &",375000,0,-375000
R292628,RP & ASSOCIATES,"PALAZZO,RANDALL A",375000,0,-375000
R112613,"VAN DOMELEN,DAVID J","VAN DOMELAN,DAVID J-47.2%",375000,0,-375000
R303872,"PICKAR,ARNOLD D &","PICKAR,ARNOLD D",375000,0,-375000
R281124,"YAGUDA,STEW &","YAGUDA,STEWART D TR &",375500,0,-375500
R179806,"JAMESON,ROBERT","JAMESON,ROBERT &",376000,0,-376000
R329414,"DAVIS,TERRY G","KROCHAK,HOWARD D &",378000,0,-378000
R112864,"GWILLIAM,GILBERT F III &","GWILLIAM,GILBERT F TR-1/2 &",378000,0,-378000
R112864,"GWILLIAM,GILBERT F III &","GWILLIAM,GILBERT F TR-1/2 &",378000,0,-378000
R217367,"BROWN,HARRY R JR &",Sale In Progress,378700,0,-378700
R143146,"STEVENS,DANNELLE D","STEVENS,DANNELLE D TR",379000,0,-379000
R285733,"SANTNER,SARAH &","SANTNER,SARAH &",379000,0,-379000
R250013,"DUCA,LORRAINE M","DUCA,LORRAINE M TR",379500,0,-379500
R495899,"WILLIAMSON,CARLA","WILLIAMSON,CARLA J TR",379900,0,-379900
R287891,"KELLY,MICHAEL T","KELLY,MICHAEL T &",380000,0,-380000
R565748,"PEMENT,SIDNEY F","VILLANUEVA,SIDNEY F &",380000,0,-380000
R267954,"HANSEN,ROBERT C &","HANSEN,ROBERT C",380000,0,-380000
R292152,"MAREINA,ELLEN","MAREINA,ELLEN A TR",380000,0,-380000
R179958,"JAKUBOWSKI,TIMOTHY S &","JAKUBOWSKI,TIMOTHY S &",380600,0,-380600
R280858,"LEIKAM,SONIA-MARIE",ROSE CITY RENTALS LLC,384500,0,-384500
R114640,"KIRCHER,TIMOTHY J &","KIRCHER,TIMOTHY J &",385000,0,-385000
R219146,"FARR,JANET A","FARR,JANET A TR",385000,0,-385000
R268931,"BARRITT,JOHN A &","KOYA,RAMIZA S",385000,0,-385000
R316248,"FRANCE,KEVIN &",HOUSE TO HOME RENOVATION LLC,385000,0,-385000
R303763,"GATOV,ANDREA &","JOHNSTON,LEVI G &",385000,0,-385000
R216363,"BLEVINS,LINDA M TR &","BLEVINS,LINDA M TR-50% &",385000,0,-385000
R280749,"FERGUSON,ANTHONY &",TORO REAL ESTATE LLC,385000,0,-385000
R283235,"MCCLURE,JON M &","MARTIN,MARIE V",385800,0,-385800
R160538,"LABARRE,LAWRENCE K",LAWRENCE K LABARRE REVOCABLE,386000,0,-386000
R170178,"EIDEMILLER,LARRY R TR &","EIDEMILLER,LARRY R TR &",386700,0,-386700
R280442,"GIBBONS,ERIC &","NAGAYAMA,ATSU",387000,0,-387000
R307314,RP & ASSOCIATES LLC,"PALAZZO,RANDALL A",387500,0,-387500
R134279,"COLLISON,ERIC R &","COLLISON,ERIC R TR &",388000,0,-388000
R211158,"PENDER,JESSE S","PENDER,JESSE S &",388000,0,-388000
R143087,"ELLIOTT,ALICIA S","ELLIOTT,ALICIA S TR",389000,0,-389000
R189533,"HESSE,GERALD J &","HESSE,GERALD J TR &",389900,0,-389900
R532842,"PARKER,JAMES &","PARKER,CRAIG R &",390000,0,-390000
R340345,"BRUGH,STEPHEN A","BRUGH,STEPHEN A &",390000,0,-390000
R273471,"MAXSON,BARRIE &","MAXSON,BARRIE TR &",390000,0,-390000
R532842,"PARKER,JAMES &","PARKER,CRAIG R &",390000,0,-390000
R172381,APX PARK TWENTY-SEVEN LLC,"HEGARTY,PAUL &",392500,0,-392500
R107137,"SHORT,EMILY C &","MORDEN,TAYLOR &",393000,0,-393000
R561424,"GOLDBERG,DAVID M &","GOLDBERG,DAVID M TR &",394071,0,-394071
R330828,"MIYAMOTO,RODNEY &","MIYAMOTO,LISA",395000,0,-395000
R113225,"FERREA,ROBERT E TR &","FERREA,ROBERT E TR &",395000,0,-395000
R281196,"APPELL,HELEN","APPELL,HELEN F II TR",397500,0,-397500
R327018,"WELCH,MIKE-50% &","WELCH,MIKE-50% &",397500,0,-397500
R242784,LP WEBSTER LLC,"WEBSTER,LEONARD L TR &",398500,0,-398500
R112878,"REILLY,JOHN","REILLY,JOHN K &",399000,0,-399000
R191726,H R TRUST U/T/A/ 1/13/95,"RUBIN,LAURIE A",399000,0,-399000
R295602,"ESTRADA-BERG,ALFONSO &",CHERYL ANN DILLINGER AND,399999,0,-399999
R210282,"COODLEY,GREGG &","COODLEY,GREGG O",400000,0,-400000
R241348,"ALRED,JAMES &","ALRED,JAMES &",400000,0,-400000
R241348,"ALRED,JAMES &","ALRED,JAMES D &",400000,0,-400000
R574407,"PAN,ZHIJIANG &","PAN,ZHIJIANG &",400000,0,-400000
R189330,"SMEEKENS,MARGARET J","SMEEKENS,MARGARET J &",400000,0,-400000
R303613,"SALZBERG,KENNETH C &","SALZBERG,KENNETH C TR &",400000,0,-400000
R201168,"MILLER,STEVEN B &","MILLER,STEVEN TR &",400000,0,-400000
R242733,"CHAMBERS,JERRY A &","CUCCO,BETH TR &",400000,0,-400000
R303779,"RYAN,ANDREW J &","RYAN,ANDREW J &",400000,0,-400000
R183240,"STEELE,ROBERT L &","STEELE,ROBERT L TR &",400000,0,-400000
R157068,"SILVERMAN,BRUCE M &",CELADON PROPERTIES LLC,401000,0,-401000
R211541,"TYREE,JAMES T","TYREE,JAMES T &",402000,0,-402000
R262363,"ELDRIDGE,JOHN W &",B&E; PROPERTIES LLC,402000,0,-402000
R299101,"WALKER,REBECCA T &","WALKER,WILLIAM N JR &",405000,0,-405000
R220045,"KESSI,ROBERT K",RKK PROPERTIES LLC,405000,0,-405000
R123469,"MATUSICK,AARON",3131 SE MAIN LLC,405000,0,-405000
R188264,"WEBER,JOSEPH P &","WEBER,JOE P",405000,0,-405000
R107129,"LOFGREN,KRISTOFOR S",HAWTHORNE BUNGALOW LLC,405000,0,-405000
R118902,"WILDT,CHRISTOPHER A","WILDT,CHRISTPHER A &",409000,0,-409000
R268926,"CLAY,THEODORE &","CLAY,THEODORE H TR &",410000,0,-410000
R262572,"REILLY,JOHN K &",REILLY SIGNATURE HOMES LLC,410000,0,-410000
R221055,"DONNELLY,THOMAS","DONNELLY,THOMAS J &",410000,0,-410000
R110944,"WOGAN,PETER &","MCIVOR,MARIA",410000,0,-410000
R163942,"HEALY,LINDA","HEALY,LINDA M &",411000,0,-411000
R131047,"MCDERMOTT,MASAKO","MCDERMOTT-KRYZA,IMARI",411000,0,-411000
R115877,"AYTON,RUPERT &","AYTON,RUPERT N TR &",415000,0,-415000
R503647,"BAKER,DONALD G &","BAKER,DONALD G &",415000,0,-415000
R114787,"MARTIN,JAMES D &","MARTIN,JAMES D &",415000,0,-415000
R292961,"MINTER,RONALD S &","MINTER,RONALD &",417000,0,-417000
R153237,"LOWE,ROSALIE &",LOWLANDS PLACE LLC,417700,0,-417700
R219711,"TINKHAM,MICHAEL &","TINKHAM,MARY M TR",418000,0,-418000
R185949,"POWERS,MELISSA &","PIUCCI,STEPHEN V TR &",418000,0,-418000
R203897,"SUCH,JAMES R","SUCH,JAMES R-1/2 &",419000,0,-419000
R579148,"HANNUM,WILLIAM E TR &","HANNUM,WILLIAM TR &",419500,0,-419500
R561837,"MACKAY,JOHN E &","MACKAY,JOHN E &",420000,0,-420000
R259369,"PYRCH,CAROLYN S","PYRCH,MATTHEW J &",420000,0,-420000
R229698,"NOLTE,J MICHAEL","NOLTE,JOHN M",420000,0,-420000
R299517,"STONE,DIANE E","STONE,DIANE E TR",423000,0,-423000
R164955,"WENNERMARK,LINDA M","WENNERMARK,BERNARD R &",425000,0,-425000
R141401,FOOTPRINT NW LLC &,FOOTPRINT NW LLC,425000,0,-425000
R203358,"RUEDA,KEVIN","RUEDA,KEVIN & AMY",425000,0,-425000
R123015,"HOCHMAN,FLORENCE E","HOCHMAN,FLORENCE E TR",425000,0,-425000
R231571,"BRAKKEN,ERIC P &","BRAKKEN,ERIC TR &",425000,0,-425000
R185504,"SEMEYN,ERICA A &","JACOBSON,ERICA A &",425000,0,-425000
R153247,"TREECE,W MARTIN",SE 36TH LLC,425000,0,-425000
R243269,"POPAT,ROHIT &","POPAT,ROHIT",425000,0,-425000
R282958,AB PROPERTY MANAGEMENT LLC,"BUXBAUM,ANDREA",425000,0,-425000
R147743,"REILLY,JOHN &","REILLY,JOHN &",425000,0,-425000
R271002,"WOOSTER,LORI M","PENARANDA,LORI M",427000,0,-427000
R243841,"HARE,JOHN G &","HARE,JOHN G &",427500,0,-427500
R310155,"WILSON,PATRICK &","WILSON,GERALD P TR-1/2 &",428709,0,-428709
R254921,"DALE,STEVE","DALE,STEVE A &",429000,0,-429000
R200695,"BURNS,LESLIE A &","SPENCER,IZAAC W &",429000,0,-429000
R126184,"GEVURTZ,BERNICE","GEVURTZ,BERNICE R TR",429000,0,-429000
R109887,WEST RENTAL PROPERTIES LLC,WEST FAMILY PROPERTIES LLC,429000,0,-429000
R221035,"BEVERIDGE,MICHAEL W","BEVERIDGE,MICHAEL W &",430000,0,-430000
R309527,"LATTIMER,JOHN L &","LATTIMER,JOHN N &",430000,0,-430000
R189231,"KLOVEE-SMITH,ELI &","KLOVEE-SMITH,ELI TR &",430000,0,-430000
R185127,"SANSTRUM,ALETA &","SANSTRUM,ALETA S",430000,0,-430000
R244667,"ANAND,BRIJESH &",BELMONT INVESTMENT PROPERTIES LLC,430000,0,-430000
R327764,RUBY NORTHWEST LLC,"HALPIN,FRANCIS A &",430000,0,-430000
R644976,"MOELLER,GERARD &","MOELLER,GERARD J TR &",431159,0,-431159
R219172,"ANDERSON,DOUGLAS W EST OF","ANDERSON,SUSAN E",432500,0,-432500
R242748,"ROMAN,DANNY","ROMAN,DANNY TR",433000,0,-433000
R259798,"CLONINGER,KATHRYN A","CLONINGER,KATHRYN A TR",434000,0,-434000
R259798,"CLONINGER,KATHRYN A","CLONINGER,KATHRYN A TR",434000,0,-434000
R123275,NEVCOL LLC,BEEPA LLC,434000,0,-434000
R260390,"CORRELL,RICHARD L &","CORRELL,RICHARD L TR",434900,0,-434900
R202651,"STARK,TIFFANY M &","STARK,TIFFANY M",435000,0,-435000
R152501,"EVIC,LANCE",LEVEL 3 HOMES LLC,435000,0,-435000
R190245,"HAYWOOD,TODD R &","HAYWOOD,TODD R &",439000,0,-439000
R295394,"LUDWIG,ARIC B &","HUNT,SUSAN",439900,0,-439900
R204317,"HOGAN,DENNIS E &","HOGAN,DENNIS E TR &",440000,0,-440000
R337077,"BLAGA,DANIEL I &","COVACI,SOFIA",440000,0,-440000
R267106,"BURCH,ARCHIE &","BURCH,ARCHIE TR &",440000,0,-440000
R145298,"HVAL,BRETT C &","SANDERS,HEIDI J",440000,0,-440000
R122945,"BRUNETT,CAROLYN ANN R","BRUNETT,PATRICK H TR &",440020,0,-440020
R266533,"HECHT,MARGRIET","HECHT,MARGRIET TR",444000,0,-444000
R202701,"KYSAR,MARY","KYSAR,MARY &",445000,0,-445000
R218727,"ANOROVA,MARGARITA","ANOROVA,MARGARITA &",445000,0,-445000
R326588,"MUDD,SAMUEL E","MUDD,SAMUEL &",445000,0,-445000
R271089,"TACHIKI,HARRY U &",THE HARRY TACHIKI & BARBARA,445000,0,-445000
R203280,"KASS,DANIEL S","KASS,DANIEL",445000,0,-445000
R147747,"EVIC,LANCE",LEVEL 3 HOMES LLC,445450,0,-445450
R223361,"STRAUCH,JENNIFER &","STRAUCH,STEVEN",446500,0,-446500
R268541,"SACKS,ROBERT A &","SACKS,ROBERT A TR &",447000,0,-447000
R126175,"KIRWAN,LYNN","KIRWAN,LYNN M",448000,0,-448000
R204203,"HARRIS,DENISE","HARRIS,DENISE TR",448000,0,-448000
R147219,"PETERSEN,ALAN &","PETERSEN,ALAN TR &",449000,0,-449000
R567886,"JONES,DANIEL W &","JONES,DANIEL W TR (1/2) &",450000,0,-450000
R202755,"GARNER,SHERRI",MULTNOMAH COUNTY,450000,0,-450000
R270432,"SHERWOOD,DON C TR &","SHERWOOD,PATRICK H",450000,0,-450000
R188865,"GORDON,MARK &","GREEN,KEVIN A &",450000,0,-450000
R627515,"CRANDALL,DAVID &","CRANDALL,DAVID-1/2 &",450000,0,-450000
R223699,GREAT HORNED OWL LLC,"GALFORD,CHARLES A-90% &",450000,0,-450000
R188564,"WIESENECK,JILL I","WIESENECK,JILL I TR",450000,0,-450000
R134386,"HOLLOWAY,SAMUEL G","HOLLOWAY,SAMUEL G &",450000,0,-450000
R273039,"SCHAEFER-CARNES,DAGMAR","SCHAEFER,DAGMAR",450000,0,-450000
R122214,"LAGOSH,LISETTE A","LAGOSH,LISETTE A &",452000,0,-452000
R234161,"FIESTAL,JUDITH","FIESTAL,JUDITH A TR",456000,0,-456000
R152979,"REITER,CAROLYN &","FUJITA,CAROLYN &",456900,0,-456900
R171413,"GULLEY,JANET M","KAHL,THOMAS A &",457000,0,-457000
R112652,"DALTON,JAMES S &","DALTON,JAMES S &",459000,0,-459000
R204099,"BEHR,FREDERICK","BEHR,FRED TR",459000,0,-459000
R122933,"KLEINHEINZ,STEVE","KLEINHEINZ,STEPHEN J &",460000,0,-460000
R188332,"GORDON-LICKEY,MARVIN &","GORDON-LICKEY,MARVIN E TR &",460000,0,-460000
R230672,"HASTIE,CATHY","HASTIE,CATHERINE J TR",462200,0,-462200
R106537,"FAHLAND,GERDON R TR","FAHLAND,GERDON R &",464900,0,-464900
R152375,"LANGDON,CAROL P TR","LANGDON,CAROL P",465000,0,-465000
R101534,"BRANDTS,J ROBERT &","BRANDTS,J ROBERT TR &",465000,0,-465000
R540135,"SMITH,JEFFREY K &","SMITH,MARY F TR",465000,0,-465000
R124902,"LANGLEY,VICKIE &","LANGLEY,LEONARD L TR &",465000,0,-465000
R152375,"LANGDON,CAROL P TR","LANGDON,CAROL P",465000,0,-465000
R150872,"KRAFT,ROBERT L","KRAFT,ROBERT L TR",465000,0,-465000
R309559,"ROTH,ARTHUR L TR &","ROTH,ADAM",468900,0,-468900
R124077,"DYKHOUSE,JANS T","DYKHOUSE,JANS T &",469000,0,-469000
R124077,"DYKHOUSE,JANS T",Sale In Progress,469000,0,-469000
R252738,"DAVIS,JESSICA N &","OTTING,NICHOLAS JOHN TR-50%",469900,0,-469900
R283129,"HIEHLE,GENE &","HIEHLE,GENE TR &",469950,0,-469950
R178263,"PRITIKIN,WILLIAM","PRITIKIN,RALPH W &",470000,0,-470000
R179941,"HOWARD,BRUCE",RENAISSANCE CUSTOM HOMES LLC,470000,0,-470000
R259745,"CHANG,ERIC C &","CHANG,ERIC C &",472000,0,-472000
R218445,"REEDY,WILLIAM &","REEDY,RHONDA TR &",474900,0,-474900
R597913,"CARGILL,DANIELA B","BROD,DANIELA ELIZABETH",475000,0,-475000
R188952,"SMITH,ELIZABETH S G","GETTY,ELIZABETH S",475000,0,-475000
R176762,"SMITH,KIM","KIM,MOLLY T &",475000,0,-475000
R145581,"FITZGERALD,DAVID J &","FITZGERALD,DAVID J",475000,0,-475000
R226602,"WESTER,BARRY","WESTER,BARRY TR",478000,0,-478000
R129541,"NOE,TERESA",NW FINANCIAL NETWORK INC,479000,0,-479000
R299817,"HANSEN,MELODY &",HOUSE TO HOME RENOVATION LLC,480000,0,-480000
R203358,"PHILLIPS,JANICE M","PHILLIPS,JANICE M TR",480000,0,-480000
R243664,"HILLE,JENNIFER","REECE,JENNIFER S",482000,0,-482000
R134237,TRISEGER HOMES LLC,1150 SE SELLWOOD LLC,482500,0,-482500
R576978,"LONGLEY,JEANNE","LONGLEY,JEANNE TR",483000,0,-483000
R212323,"AMAN,NATHAN &","AMAN,NATHAN",485000,0,-485000
R110070,"KNOLL,PATRICIA A &","SALK,DARRELL J-2/3 &",485000,0,-485000
R153088,"HENARIE,ROBERT L &","HENARIE,ROBERT L ET AL",485900,0,-485900
R174337,"BOWEN,CRAIG G &","BOWEN,CRAIG G &",486000,0,-486000
R188329,"MORGAN,CAROL L","MORGAN,CAROL L TR",486000,0,-486000
R323938,"MEYER,DOUGLAS J &","MEYER,DOUGLAS J TR &",487000,0,-487000
R202547,"MILLER,JUDITH J","MILLER,JUDITH JAN H TR",487500,0,-487500
R221149,"POWELL,GLADYS","POWELL,GLADYS C TR",489000,0,-489000
R124923,"ASCHKENASY,RUTH H TR","ASCHKENASY,DAVID G",490000,0,-490000
R191227,"STEINER,ANDREW M","STEINER,ANDREW M &",490000,0,-490000
R260512,"WEINFUSS,ALLYSON &","SAVAGE,ALLYSON &",490000,0,-490000
R202453,"BUNKER,GILLIAN L","BUNKER,GILLIAN L &",492000,0,-492000
R173608,"BEARD,CHRIS A","BEARD,CHRIS A &",494465,0,-494465
R279860,"KLICH,MARY M &","KLICH,MARY JO",494900,0,-494900
R154461,"PIERCE,JAMES C &","PIERCE,JAMES C ET AL",495000,0,-495000
R154461,"PIERCE,JAMES C &","PIERCE,JAMES C TR-1/2 &",495000,0,-495000
R163752,"HENRY,TIMOTHY J &","HENRY,TIMOTHY J TR &",499000,0,-499000
R163752,"HENRY,TIMOTHY J &","HENRY,TIMOTHY J TR &",499000,0,-499000
R200536,"AVENA,JOSE L","AVENA,JOSE L &",499900,0,-499900
R340755,CHEX PARK III LLC,CT LLC,500000,0,-500000
R147783,"REILLY,JOHN K &","REILLY,JOHN K &",500000,0,-500000
R146984,"QUIGLEY,DAN &","QUIGLEY,DANIEL &",502500,0,-502500
R263337,"MARQUARD,MICHAEL S &","MARQUARD,JULIE A",505000,0,-505000
R152503,"BLAND,WARREN R &","BLAND,WARREN R TR &",506000,0,-506000
R259694,"MAC LEOD,OLIVIA M","DWINELL,OLIVIA M",508070,0,-508070
R255048,"CHIN,PHILLIP &","CHIN,PHILLIP TR &",509000,0,-509000
R207176,"MONAHAN,RACHEL A &","MONAHAN,RACHEL &",510000,0,-510000
R495908,"BECKER,MARY C",US BANK NA TR,512500,0,-512500
R123171,"SAMPAT,KETAN R &",ANKENY HOUSE LLC,515000,0,-515000
R203430,"LANCEFIELD,JUDITH A &","PALL,MARTIN L",518000,0,-518000
R109268,"HEPBURN,DENIS R TR &","HEPBURN,DENIS R TR-1/2 &",519500,0,-519500
R159945,LITTLE BEAR DEVELOPMENT LLC,"HOWARD,KEVIN M TR &",2050000,1530000,-520000
R259429,"PARMISANO,LAURA","PARMISANO,LAURA TR",520000,0,-520000
R193147,"KRAFT,JEFF &","SCHMIEDE,ANGELA E TR &",520000,0,-520000
R309415,"SCHECHTERMAN,STEVEN N","ZIEGLER,MARCIE R",521150,0,-521150
R152237,"BARTELETTI,ROBIN &","BARTELETTI,ROBIN E",524000,0,-524000
R152237,"BARTELETTI,ROBIN &","BARTELETTI,ROBIN &",524000,0,-524000
R177578,"KRISHNAN,BRINDA S &","LOCKEY,CHRISTOPHER J",535000,10000,-525000
R182943,"KILTY,JOHN &","KILTY,JOHN E",525000,0,-525000
R190688,"JONES,DANNY J",DK HOMES LLC,525000,0,-525000
R263792,"HOGGARD,J BLAINE &","HESS HOGGARD,KATHRYN",525000,0,-525000
R263792,"HOGGARD,J BLAINE &",Sale In Progress,525000,0,-525000
R342574,"MCDONALD,CAROL M","GURTOV,JODI M TR &",525000,0,-525000
R325227,"ROBERTS,JANE J &","ROBERTS,JANE R &",525000,0,-525000
R342574,"MCDONALD,CAROL M","GURTOV,JODI M TR &",525000,0,-525000
R307130,"SQUIRES,JOE &",ADMIRAL PROPERTIES LLC,526000,0,-526000
R304031,"FLETCHER,BRADFORD H","FLETCHER,ALEXANDER H &",528300,0,-528300
R258404,"MAYES,STACI F","MAYES,STACI F &",528300,0,-528300
R114617,"INDRIKIS,AIJA I","GRAHAM,ANDRA I",529000,0,-529000
R233997,"HURLEY,WILLIAM S &","HURLEY,WILLIAM S",529000,0,-529000
R153104,"ELLIS,MICHAEL &","ELLIS,MICHAEL J TR &",530000,0,-530000
R231782,"SQUIRES,JOSEPH &",ADMIRAL PROPERTIES LLC,530000,0,-530000
R300954,"COSTA,LINN K O R","COSTA,LINN K O R &",530000,0,-530000
R259607,"MORENO,HENRY J &","KAHL,PAMELA A &",531500,0,-531500
R132912,"JURRENS,SARAH B","PLATT,SARAH B",533800,0,-533800
R267028,"ANGELUZZI,DIANE T","KNAPP,DIANE T",535000,0,-535000
R145673,"BINDER,LAURENCE M &","WOOD-HULL,LARRY D &",535000,0,-535000
R283176,"COSEO,DAVID C &","COSEO,DAVID C &",535000,0,-535000
R203867,"BENNETT,ROBERT &","BENNETT,ROBERT C &",535025,0,-535025
R248198,"MURRAY,KATHERINE E","MURRAY,KATHERINE E TR &",539000,0,-539000
R342568,"UEDA,SHAWN",MUD DOG FARM LLC,539950,0,-539950
R301084,"ETESSAM,DARIUSH &","ETESSAM,DARIUSH ET AL",540000,0,-540000
R206478,"MINUS,PETER A &","FAHEY,MATTHEW G",540000,0,-540000
R229698,"VALENCIA,ED",2738 SW OLD ORCHARD ROAD LLC,541500,0,-541500
R243215,"TIPPETT,JOSH H &","TIPPETT,JOSH H",550000,6500,-543500
R187732,"LUSTBERG,LYNN","LUSTBERG,LYNN",544000,0,-544000
R202891,"LAY,SUSAN A","LAY,SUSAN A &",544500,0,-544500
R152525,"GOW,JACK A &","GOW,JACK A TR &",545000,0,-545000
R259806,OUR LADY OF LAVANG,Sale In Progress,545000,0,-545000
R270847,"AUSTIN,ALYSON","AUSTIN,GREGORY S &",545000,0,-545000
R152525,"GOW,JACK A &",Sale In Progress,545000,0,-545000
R152525,"GOW,JACK A &","GOW,JACK A TR &",545000,0,-545000
R114108,"SILVERSTEIN,SIMON &","SILVERSTEIN,SIMON &",547000,0,-547000
R112391,"RENNIE,CHRISTOPHER T &","RENNIE,CHRISTOPHER TR &",548000,0,-548000
R260071,"DRAIN,SARAH","DRAIN,SARAH E",550000,0,-550000
R154466,"LANDAU,ROBERT &","LANDAU,ROBERT",550000,0,-550000
R102265,"JACKSON,SCOTT D &","JACKSON,SCOTT D",550000,0,-550000
R266490,"STRIEMER,JUERGEN &","STRIEMER,JUERGEN TR &",550000,0,-550000
R260071,"DRAIN,SARAH",Sale In Progress,550000,0,-550000
R285314,"MCCARTER,LESLIE &","MCCARTER,LESLIE W TR &",550000,0,-550000
R119962,"WILKES,ROBERT M &","WILKES,ROBERT M TR &",550000,0,-550000
R267924,"MOSS,LOIS K TR-1/2 &","MOSS,LOIS K TR-1/2 &",556431,0,-556431
R251313,"LIPPMAN,STEVEN A &","LIPPMAN,STEVEN A-50% &",559950,0,-559950
R141733,"FECHNER,JOANN K","FECHNER,JOANN K-91.87% &",615000,50000,-565000
R152956,"MC DERMOTT,JAMES P &","MCDERMOTT,JAMES P TR &",567500,0,-567500
R253342,"CHELICO,PETER &","CHELICO,PETER JR &",567500,0,-567500
R121278,"GOODMAN,CHARLES","GOODMAN,M CHARLES TR",570000,0,-570000
R123494,"BICKFORD,BRANDON E","BICKFORD,BRANDON",570000,0,-570000
R277810,"FREY,RICHARD E &","FREY,RICHARD E TR &",574000,0,-574000
R342914,"YUCKERT,CONRAD M","YUCKERT,CONRAD M TR-1/2 &",575000,0,-575000
R247440,"CORCORAN,ETHAN E &","CORCORAN,ETHAN E TR &",575000,0,-575000
R158235,PORTLAND CITY OF,PORTLAND CITY OF,575000,0,-575000
R267212,"CUDO,JONATHAN R","CUDO,JONATHAN R &",575000,0,-575000
R152899,"DAVIS,KATHERINE M &","DAVIS,KENNETH R SR &",575000,0,-575000
R269445,"FLANAGAN,ZOE H","FLANAGAN,ZOE H TR",575000,0,-575000
R121333,"SPEAR,WILLIAM D &","SPEAR,MARY ANN M TR &",577000,0,-577000
R260850,"ROBERTS,JOHN B","ROBERTS,JOHN B TR",579900,0,-579900
R174262,"BIGELOW,ANNE L","CHRISTENSEN,MARIAN E &",580000,0,-580000
R260953,"SMITH,JAMES S &","SMITH,JAMES S TR &",581500,0,-581500
R121385,"DESHLER,WILLIAM","DESHLER,ALEXANDER W &",583000,0,-583000
R272463,"CONTE,CARRIE","CONTEE,CARRIE A TR",585000,0,-585000
R272463,"CONTE,CARRIE","CONTE,CARRIE A TR",585000,0,-585000
R282597,"LIERE,AARON M &","LIERE,AARON M &",585000,0,-585000
R304893,"KIRKHAM,MEGAN &","KIRKHAM,MEGAN &",587325,0,-587325
R291196,"SINN,ERIC","SINN,ERIC &",590000,0,-590000
R218695,"PFEFER,CHAD T &","PFEFER,CHAD T",595000,0,-595000
R107573,"JOHNSTON,FRANCES L &","JOHNSTON,FRANCES L",595500,0,-595500
R651513,"MOHLMAN,ROBERT L","MOHLMAN,ROBERT L &",599000,0,-599000
R258008,"MUTNICK,JEFFREY S","MUTNICK,JEFFREY S TR",600000,0,-600000
R263804,"KEPPINGER,JAMES T-50% &","KEPPINGER,JAMES T-50% &",600000,0,-600000
R502620,"LAKIN,COURTNEY E &","REXFORD,CLINT &",600000,0,-600000
R178541,"NIES,FRANK C &","NIES,FRANK C &",600000,0,-600000
R273440,"FAHERTY-MORSE,LIZABETH A","FAHERTY,LIZABETH A",600000,0,-600000
R154272,"ORLOFF,CAROLE S","ORLOFF,CAROLE S TR",604500,0,-604500
R100242,"USHER,ANNE",MODOC PROPERTIES LLC,605000,0,-605000
R152685,"BURNS,LYNN P","PASTORIUS,LYNN",605000,0,-605000
R152908,"CLAY,EMILY &","CLAY,EMERY D TR &",610000,0,-610000
R203980,"BABB,PAULA J","BABB,PAULA J TR",610000,0,-610000
R112939,"MITCHELL,CHARLES F &","MITCHELL,CHARLES F &",619700,0,-619700
R112939,"MITCHELL,CHARLES F &","MITCHELL,BARBARA G &",619700,0,-619700
R128289,"WILSON,LAWRENCE R",MITTENS & YEMEN PDX LLC,2500000,1880000,-620000
R107396,"ALDERMAN,JEFFREY &","USHIYAMA,SHIZUKO TR &",620000,0,-620000
R272518,"SAAL,ROBERT J &","SAAL,ROBERT J",625000,0,-625000
R224969,"JOHNSON,JOSHUA R &",POINTE WEST PROPERTIES LLC,625000,0,-625000
R165402,"CIFFONE,DONALD L &","CIFFONE,DONALD L TR-50% &",627000,0,-627000
R184196,"SLEEPER,BETSY F","SLEEPER,BETSY F TR",630000,0,-630000
R253156,"MICHAELS,EUGENE &","MICHAELS,EUGENE TR &",631000,0,-631000
R200453,"RIVERS,LUCIUS M III &","RIVERS,LUCIUS M III",635000,0,-635000
R212573,"LIPTON,NANCY","LIPTON,NANCY TR &",636400,0,-636400
R212573,"LIPTON,NANCY","LIPTON,NANCY TR &",636400,0,-636400
R188956,"PAYMAR,SUZANNE G","GEARY,SUZANNE",639000,0,-639000
R213510,"BYERLY,KATHRYN J &","HUTCHINSON,JAMES E TR &",639000,0,-639000
R188176,"WAGGONER,BENJAMIN &","WAGGONER,BENJAMIN",639441,0,-639441
R187732,"SQUIRES,STACEY",ADMIRAL PROPERTIES LLC,640000,0,-640000
R152502,METRO HOMES NORTHWEST LLC,METRO HOMES NORTHWEST LLC-50% &,640000,0,-640000
R152909,TRISEGER HOMES LLC,7101 SE REED COLLEGE PL LLC,641500,0,-641500
R188818,"SELIGMAN,MARK &","SELIGMAN,MARK TR &",642500,0,-642500
R188151,"ANDERSEN,DENNIS A","ANDERSEN,DENNIS A TR",643000,0,-643000
R301122,"KEAST,ROGER &","KEAST,ROGER TR &",648000,0,-648000
R202712,"LINDHORST,DONALD B","LINDHORST,DONALD B &",648000,0,-648000
R108756,"JAMES,ROBERT D &","JAMES,ROBERT D &",649850,0,-649850
R230233,"WARD,MATTHEW","WARD,MATTHEW &",650000,0,-650000
R220968,"EPPERSON,ERIC R &","EPPERSON,ERIC R",650000,0,-650000
R342234,"USKOSKI,GLENN R TR &","USKOSKI,GLENN R &",650000,0,-650000
R112556,"REINERS,ANDREA",EAST ARM LLC,650000,0,-650000
R326910,SPRINGWATER DEVELOPMENT LLC,"LARNER,ALBERT E &",650000,0,-650000
R188539,"BARASCH,RICHARD S &","BARASCH,RICHARD S &",652000,0,-652000
R188539,"BARASCH,RICHARD S &","BARASCH,RICHARD S &",652000,0,-652000
R177232,"HOANG,SON T &","HOANG,SON &",660000,0,-660000
R107375,TENIR LLC-66.56% &,"GARDNER,BENJAMIN D-66.56% &",2000000,1337955,-662045
R171418,"BALDWIN,JAMES F","BALDWIN,JAMES F TR",665000,0,-665000
R191172,"LEHMANN,KRISTINE","LEHMANN,KRISTINE TR &",667000,0,-667000
R198522,"ARZT,PHILIP G &",PGPAS LLC,667000,0,-667000
R154283,"MOOERS,CHRISTOPHER N K &","MOOERS,CHRISTOPHER N K TR &",670000,0,-670000
R268779,"KELMAN,GLORIA &","FREUDMANN,GIDEON",671000,0,-671000
R283169,"SORENSON,DUANE","SORENSON,DUANE A TR",672000,0,-672000
R133313,ENTRUST NORTHWEST LLC,"DREYZEN,ALEXANDER",674900,0,-674900
R133313,ENTRUST NORTHWEST LLC,"DREYZEN,ALEXANDER",674900,0,-674900
R167593,"ROSENBERG,ALAN J &","ROSENBERG,ALAN J &",679000,0,-679000
R295822,"DETORE,FREDERICK J &","DETORE,MIRANDA K",679900,0,-679900
R236384,"SELLIN,MARK D &","SELLIN,MARK D TR &",680500,0,-680500
R187727,"HAKKI,MARIA","HAKKI,BASIL W &",685000,0,-685000
R308061,"WALTERS,ANTON J &","WALTERS,SHARON L",685000,0,-685000
R112676,"MCCULLOCH,JOHN",MCCULLOCH CONSTRUCTION CORP,693000,0,-693000
R147320,"FRIEDMAN,JACK A &","FRIEDMAN,JACK A TR &",695000,0,-695000
R273311,"PANAHPOUR,ALI","PANAHPOUR,ALI &",695000,0,-695000
R120879,"REED,MARY E","FLECKER,ROBERT H &",695000,0,-695000
R198414,"HALSEY,STEPHEN S &","HALSEY,STEPHEN S TR &",695250,0,-695250
R198414,"HALSEY,STEPHEN S &","HALSEY,STEPHEN S TR &",695250,0,-695250
R312569,"POND,JAMES W &","POND,JAMES W JR TR &",699000,0,-699000
R111174,"BEECK,SYDNEY B &",GARDEN PROPERTIES LLC,699000,0,-699000
R506849,"BOUDREAUX,CHRISTOPHER &","BOUDREAUX,CHRISTOPHER &",699900,0,-699900
R232880,"HOFFMAN,JOSHUA M &","HOFFMAN,JOSHUA M TR &",699900,0,-699900
R169934,"BRENDLER,KEN &","BRENDLER,KEN M TR &",700000,0,-700000
R188158,"DEMURO,SUSAN A","DEMURO,SUSAN A TR",705000,0,-705000
R117653,"CRITES,THOMAS R &","CRITES,THOMAS R &",707000,0,-707000
R113177,"MCCULLOCH,JOHN","MCCULLOCH,JOHN D",710000,0,-710000
R184203,"WATSON,TRACY L &","WATSON,TRACY L",710000,0,-710000
R188649,"ROBERTS,MARCI L","LANE,MARCI",715000,0,-715000
R165232,"BALDINO,JAMES J &","BALDINO,DEENA L TR &",715000,0,-715000
R303694,"BRADFORD,JOSEPH G",GALAXIE APARTMENTS LLC,716295,0,-716295
R208842,"STARR,JASON M &","STARR,JASON M TR &",716875,0,-716875
R327812,"OKULEY,JAMES M &","OKULEY,JAMES M",720000,0,-720000
R272463,"DRYER,JANN I &","DRYER,JANN I",727000,0,-727000
R285252,"HO,MARY J","HO,ROBERT W H TR &",729000,0,-729000
R593701,"MOLINARO,MICHAEL J &","MOLINARO,JAN SUSAN TR",730000,0,-730000
R123271,"HOOFARD,JEFFREY L &","HOOFARD,JEFFREY L TR &",730000,0,-730000
R123271,"HOOFARD,JEFFREY L &","HOOFARD,JEFFREY &",730000,0,-730000
R283161,"WALKER,LINDA A","FREY,NATHAN A &",735000,0,-735000
R230224,"RIDER,SCOTT A",Sale In Progress,738090,0,-738090
R122931,"BENTLEY,SARA M","MCHUGH,SARA M",740000,0,-740000
R179379,"CROCKER,MATTHEW R",THE BANK OF NEW YORK MELLON TR,2000000,1260000,-740000
R141328,NTC & COMPANY ET AL,PENSCO TRUST COMPANY CSTDN ET AL,740025,0,-740025
R227114,"CZOPEK,KAREN &",HIRSCH HOUSE LLC,742500,0,-742500
R117355,"DEVLIN,KEVIN","DEVLIN,KEVIN E &",749000,0,-749000
R532851,"HSU,CHA MING","HSU,CHA MING &",750000,0,-750000
R128919,"LEY,DAVID P &","LEY,DAVID P",750000,0,-750000
R308018,"LANG,DINA A","LANG,DINA TR",750000,0,-750000
R162285,"CIVELLO,ANTHONY N &","DEL SOLAR,ERIN C &",755000,0,-755000
R175644,"STRAWITZ,JULIE A","YAGUDA,STEWART D TR &",760000,0,-760000
R544037,"AMESTOY,SHARON G","AMESTOY,SHARON G TR",765000,0,-765000
R173475,"ELKANICH,DAVID J &","MARGOLIS,AMY T",769000,0,-769000
R308017,"DENVER,CARA &","JACOBSEN,CARA M &",780000,0,-780000
R531843,"GU,YUAN","ZHANG,JIANMEI &",780000,0,-780000
R127306,"HORNER,RODRIC",WYNDYM DEVELOPMENT LLC,780000,0,-780000
R263807,"RENECKER,LAURIE","RENECKER,LAURIE J",783000,0,-783000
R263807,"RENECKER,LAURIE",Sale In Progress,783000,0,-783000
R328758,"OLSZEWSKI,BRETT A &","OLSZEWSKI,NICOLE A TR &",784000,0,-784000
R188604,"KALLIO,ADAM C &","KALLIO,ADAM C TR-50% &",800000,0,-800000
R325800,"LORENZ,DAVID B",C JOHNSON ENTERPRISES INC,800000,0,-800000
R325800,"LORENZ,DAVID B","LORENZ,CINDY",800000,0,-800000
R325800,"LORENZ,DAVID B","LORENZ,CINDY",800000,0,-800000
R108816,"GROFF,FRANK","GROFF,FRANK TR",820000,0,-820000
R341891,EAST MULTNOMAH SOIL & WATER,EAST MULTNOMAH SOIL & WATER,825000,0,-825000
R643793,"GILBERTSON,THOMAS A &","GILBERTSON,THOMAS TR &",825000,0,-825000
R112730,"GOLDSTEIN,ROBERT M","GOLDSTEIN,ROBERT M TR",835000,0,-835000
R285220,"REVERMAN,ARDYS U","REVERMAN,ARDYS U TR",840000,0,-840000
R223418,"KOLKENA,MAGGIE &","DUNN,SUSAN P &",849000,0,-849000
R108763,"STERN,ANDREW P &","STERN,ANDREW P &",850000,0,-850000
R108763,"STERN,ANDREW P &","STERN,ANDREW P &",850000,0,-850000
R108763,"STERN,ANDREW P &","STERN,ANDREW P &",850000,0,-850000
R108763,"STERN,ANDREW P &","STERN,ANDREW P-1/3 &",850000,0,-850000
R127324,"KAPLAN,STEVEN H TR &","KAPLAN,STEVE H TR &",855000,0,-855000
R203870,3316 SE ANKENY LLC,HARRY GREEN HOUSE LLC,870000,0,-870000
R188196,"WARNER,SHANNON M","WARNER,SHANNON M &",875000,0,-875000
R246710,"LYNCH,WILLIAM M &","LYNCH,WILLIAM M TR &",880500,0,-880500
R100984,"TADJEDIN,AMIR &","TADJEDIN,AMIR H TR &",882500,0,-882500
R517234,"RASK,MATTHEW N &","RASK,MATT N &",885000,0,-885000
R198258,"HERO,PETER &","HERO,PETER TR &",885000,0,-885000
R188167,"PAULSON,JANE S","PAULSON,JANE S &",895100,0,-895100
R174418,"FITZLOFF,MARK L &","FITZLOFF,MARK L TR 1/2 &",902000,0,-902000
R128567,"EHLEN,NICHOLAS R","EHLEN,NICHOLAS R TR",915000,0,-915000
R327363,L^8 DYNASTY LLC,"LI,LI &",920000,0,-920000
R134237,"STEVENSON,ELLEN B &","STEVENSON,W SCOTT TR &",931000,0,-931000
R531849,"WEBSTER,LANE &",LANE AND BROOKE WEBSTER,940000,0,-940000
R174583,"JACOBSON,BEN &","JACOBSON,BEN E TR ET AL",941500,0,-941500
R327759,"ANDRES,JENNIFER &","ANDRES,BRETT M TR &",945000,0,-945000
R165337,"MCRAE,ELIZABETH S &","MEYER,ELIZABETH M &",950000,0,-950000
R165159,"MIRANDO,MICHAEL","MIRANDO,MICHAEL J TR",950000,0,-950000
R307970,"CARRUTH,GEORGE A &","CARRUTH,GEORGE A &",975000,0,-975000
R108668,"MARGOLIS,JEFFREY &","MARGOLIS,JEFFREY TR &",975500,0,-975500
R167104,"YU,MABEL GRISELDIS-75% &","YU,KITSON SZEWAI",979900,0,-979900
R306177,"SILLAY,JOSEPH D &","SILLAY,JOSEPH D-1/2 &",1000000,0,-1000000
R286018,"EASLY,MARILYN","EASLY,DAVID",1375000,375000,-1000000
R126147,"NIELSEN,SOREN A &","NIELSEN,SOREN A TR &",1005000,0,-1005000
R117621,"HECHT,JAMES G","HECHT,NICOYA A TR &",1050000,0,-1050000
R241240,"BOUCHER,DOUGLAS","BOUCHER,DOUGLAS TR",1050000,0,-1050000
R177812,"MCCARTY,KAREN","MCCARTY,KAREN B TR",1050000,0,-1050000
R215761,"WILENSKY,DANIEL L &","WILENSKY,DANIEL L TR &",1052500,0,-1052500
R212584,"KOHN,AARON &","KOHN,AARON A &",1093500,0,-1093500
R198179,"RAPER,PORTER G &","RAPER,PORTER G TR &",1095000,0,-1095000
R219403,SANCTUARY HOLDINGS LLC,"DUBOIS,KARLI",1100000,0,-1100000
R323944,"GREENE,KELLY S &","GREENE,K STEVE TR-50% &",1125000,0,-1125000
R172801,"SCHNITZER,HAROLD J TR &","SCHNITZER,ARLENE TR ET AL",1200000,0,-1200000
R174460,"GOLUB,MICHAEL &","GOLUB,MICHAEL R TR &",1200000,0,-1200000
R193306,"CUYLER,JAMES P &","CUYLER,JAMES P &",1200000,0,-1200000
R236398,"AAROE,DAVID W","AAROE,DAVID W TR",1202000,0,-1202000
R236398,"AAROE,DAVID W",Sale In Progress,1202000,0,-1202000
R544107,"LYTLE,STEVEN J &","LYTLE,STEVEN J &",1207000,0,-1207000
R304760,"BERG,RICHARD N &","BERG,RICHARD N TR &",1225000,0,-1225000
R188094,"GREENE,WILLIAM R","GREENE,WILLIAM R TR &",1252000,0,-1252000
R236382,"HOWELL,DONNA","HOWELL,DONNA &",1272500,0,-1272500
R179380,"NYE,CLARK R &","NYE,CLARK R",1275000,0,-1275000
R117617,"EDINGTON,CHRISTOPHER J &","EDINGTON,CHRISTOPHER J TR &",1300000,0,-1300000
R238620,"BLAIR,SAMUEL R","BLAIR,SAMUEL R TR",1325000,0,-1325000
R238620,"BLAIR,SAMUEL R","BLAIR,SAMUEL R TR",1325000,0,-1325000
R304619,"FIELD,JOSEPH A &","FIELD,JOSEPH A",1400000,0,-1400000
R232804,"MC BETH,R BLAIR JR","MC BETH,R BLAIR JR &",1425000,0,-1425000
R198282,"COLLIE,WENDY R &","COLLIE,FRANK S TR &",1435000,0,-1435000
R104585,"GLADE,PETER H &","GLADE,PETER H &",1450000,0,-1450000
R108784,"WEIL,ELIZABETH H","WEIL,ELIZABETH H TR",1625000,0,-1625000
R112818,"MORE,MERCEDES R","MORE,MERCEDES R TR &",1744750,0,-1744750
R100226,"SCRUGHAM,THOMAS F",SCRUGHAM HOUSE LLC,1750000,0,-1750000
R112017,"SANTANGELO,MARK V","SANTANGELO,MARK V &",2150000,0,-2150000
R179670,"FLEISCHMAN,CHAD &","PARKER,TRACI TR-50%",2195000,0,-2195000
R232804,"CONTE,BENJAMIN J &","CONTE,BENJAMIN J &",2200000,0,-2200000
R174447,"FORD,THOMAS P","FORD,THOMAS TR &",2500000,0,-2500000
R276932,PORTLAND INVESTMENT,"ROTH,STEPHEN A TR",2950000,0,-2950000
R100287,"GOLDSTEIN,HAROLD M &","GOLDSTEIN,HAROLD M TR &",3250000,0,-3250000
R324250,"SILVER,PHILIP T","SILVER,PHILIP T TR",4200000,0,-4200000
